sqft_living,sqft_lot,waterfront,view,condition,sqft_above,sqft_basement,yr_built,yr_renovated
1340,7912,0,0,3,1340,0,1955,2005
3650,9050,0,4,5,3370,280,1921,0
1930,11947,0,0,4,1930,0,1966,0
2000,8030,0,0,4,1000,1000,1963,0
1940,10500,0,0,4,1140,800,1976,1992
880,6380,0,0,3,880,0,1938,1994
1350,2560,0,0,3,1350,0,1976,0
2710,35868,0,0,3,2710,0,1989,0
2430,88426,0,0,4,1570,860,1985,0
1520,6200,0,0,3,1520,0,1945,2010
1710,7320,0,0,3,1710,0,1948,1994
2920,4000,0,0,5,1910,1010,1909,1988
2330,14892,0,0,3,1970,360,1980,0
1090,6435,0,0,4,1090,0,1955,2009
2910,9480,0,0,3,2910,0,1939,1969
1200,9720,0,0,4,1200,0,1965,0
1570,6700,0,0,4,1570,0,1956,0
3110,7231,0,0,3,3110,0,1997,0
1370,5858,0,0,3,1370,0,1987,2000
1180,10277,0,0,3,1180,0,1983,2009
2240,10578,0,0,5,1550,690,1923,0
1450,8800,0,0,4,1450,0,1954,1979
1750,1572,0,0,3,1470,280,2005,0
2730,12261,0,0,3,2730,0,1991,0
1600,6380,0,0,3,1130,470,1959,1989
2090,10834,0,0,4,1360,730,1987,0
2360,7291,0,0,4,1360,1000,1948,0
2200,11250,0,0,5,1300,900,1920,0
2820,67518,0,0,3,2820,0,1979,2014
2600,4750,0,0,4,1700,900,1951,1999
1560,8700,0,0,4,1560,0,1967,0
2860,3345,0,0,3,2190,670,2004,2003
1820,5000,0,1,3,1640,180,1945,2010
2820,8408,0,0,3,2820,0,2014,0
3630,42884,0,0,3,2300,1330,1979,2014
3240,33151,0,2,3,3240,0,1995,0
800,4850,0,0,4,800,0,1944,0
1850,19966,0,0,4,1090,760,1992,0
1960,13100,0,2,5,1650,310,1957,0
2390,6550,0,2,4,1440,950,1955,2009
1580,16215,0,0,4,1580,0,1978,2000
1480,8625,0,0,4,1480,0,1974,0
850,6174,0,0,4,850,0,1950,1983
1770,2875,0,0,3,1770,0,1990,2009
1210,9400,0,0,2,1210,0,1949,0
1160,9180,0,0,3,1160,0,1968,1997
1970,35100,0,0,4,1970,0,1977,0
1930,10460,0,0,3,1930,0,1996,0
1270,1180,0,0,3,1270,0,2001,0
3310,42998,0,0,3,3310,0,2001,0
2710,37277,0,0,3,2710,0,2000,0
2910,35200,0,0,3,2910,0,1979,2014
2710,4500,0,0,4,1880,830,1929,0
1800,23103,0,0,3,1800,0,1968,1997
2210,9655,0,0,3,1460,750,1976,0
1920,10000,0,0,4,1070,850,1954,1979
2190,125452,0,2,3,2190,0,1968,1997
3660,11995,0,2,3,3660,0,2006,0
1320,1327,0,0,3,1040,280,2008,0
1630,1368,0,0,3,1280,350,2009,0
3310,6500,0,0,3,3310,0,2012,1912
2680,5539,0,0,3,2680,0,2013,1923
2730,54014,0,0,3,1560,1170,2007,0
2540,5050,0,0,3,2540,0,2006,0
2920,6605,0,0,3,2920,0,2012,1912
900,5000,0,0,3,900,0,1944,0
1650,14054,0,0,4,1130,520,1986,0
1010,9945,0,0,4,1010,0,1973,0
2680,7392,0,0,3,2680,0,2004,2003
2200,7350,0,0,5,1570,630,1988,0
2530,9933,0,2,3,2010,520,1990,2009
2850,7130,0,0,3,1990,860,1980,0
2280,6010,0,0,3,1140,1140,1900,2005
1900,8744,0,0,3,1900,0,1987,2000
1330,77972,0,0,3,1330,0,1928,1954
1270,1175,0,0,3,1110,160,2000,0
2170,4000,0,0,4,1610,560,1982,2011
2730,10281,0,2,3,2730,0,1996,0
2120,10202,0,0,4,1620,500,1960,2001
2490,4343,0,0,3,2490,0,2003,0
1990,7712,0,0,3,1210,780,1973,2013
3690,9892,0,0,3,3690,0,1998,2006
2540,7000,0,0,5,1320,1220,1942,0
1800,36704,0,0,4,1360,440,1978,2000
2340,7048,0,0,4,1340,1000,1979,0
2110,9519,0,0,2,2110,0,1948,0
1140,5400,0,0,5,1140,0,1908,0
1480,2185,0,0,3,1480,0,2005,0
1410,1240,0,0,3,1140,270,2006,0
1200,8063,0,0,4,1200,0,1958,1972
3180,13806,0,0,4,3180,0,1990,0
2160,9000,0,2,4,1400,760,1949,1985
2920,5000,0,0,4,2780,140,1908,0
2350,5700,0,0,4,1810,540,1939,1989
1560,5520,0,0,4,780,780,1944,0
2740,8426,0,0,4,1370,1370,1960,2001
1680,2000,0,0,3,1680,0,1909,1998
3090,12750,0,0,3,1750,1340,1968,1997
1410,1332,0,0,3,1410,0,2005,0
4010,8510,0,1,5,2850,1160,1971,0
3180,21904,0,3,3,3180,0,2000,0
2010,6000,0,0,3,1330,680,1975,0
1330,7500,0,0,3,1330,0,1961,2004
2370,6500,0,0,3,2370,0,1998,2006
1840,9240,0,0,4,1540,300,1942,1958
2910,6479,0,0,3,2910,0,2006,0
2070,7519,0,0,3,1160,910,1963,2008
4340,141570,0,0,3,4340,0,1992,0
840,5510,0,0,3,840,0,1955,2005
1240,9600,0,0,3,1240,0,1971,0
1390,4240,0,0,3,1050,340,1924,2011
2310,5000,0,0,3,2310,0,2006,0
1050,10072,0,0,3,1050,0,1986,0
2550,71874,0,0,5,1810,740,1960,0
2010,3600,0,0,3,2010,0,1902,0
1120,9022,0,0,4,1120,0,1962,0
2230,4000,0,0,3,2230,0,1954,2005
810,7158,0,0,5,810,0,1944,0
3190,16920,0,3,3,1690,1500,1976,0
1670,39639,0,0,4,1670,0,1976,1992
1970,9389,0,0,5,1140,830,1960,0
1450,6000,0,0,4,1450,0,1953,1983
13540,307752,0,4,3,9410,4130,1999,0
1880,7838,0,0,3,1880,0,1994,0
1880,6360,0,0,4,1040,840,1945,0
1410,6030,0,0,4,1410,0,1930,0
1480,3844,0,0,5,1480,0,1928,1970
1140,5250,0,0,4,1140,0,1949,1985
1920,9306,0,0,3,1000,920,1984,0
2910,6338,0,0,3,2910,0,2008,0
3240,7857,0,0,3,3240,0,1994,0
1550,15040,0,0,4,1550,0,1958,1972
2050,10200,0,0,3,1430,620,1956,2001
2220,4000,0,0,3,2220,0,2000,0
1770,8640,0,0,3,1520,250,1949,1998
2300,11700,0,0,4,1960,340,1977,0
1800,5000,0,0,4,1080,720,1942,1982
2010,9211,0,0,3,1470,540,1977,2004
1790,2700,0,0,3,1790,0,2010,0
2440,6651,0,0,3,2440,0,2014,0
1940,3211,0,0,3,1940,0,2009,0
1160,1438,0,0,3,1160,0,2001,0
3400,9692,0,0,3,3400,0,2007,0
4420,5750,0,0,3,3410,1010,2006,0
1571,2017,0,0,3,1571,0,2008,0
1620,998,0,0,3,1540,80,2010,0
1408,989,0,0,3,1408,0,2005,0
3040,4535,0,0,3,3040,0,2007,0
4490,6000,0,0,3,3200,1290,2006,0
1590,1426,0,0,3,1590,0,2014,0
2450,4247,0,0,3,2450,0,2013,1923
1440,7680,0,0,3,1200,240,1971,0
1100,3000,0,0,3,1100,0,1912,2005
1350,7740,0,0,4,860,490,1947,1988
2150,37981,0,0,3,2150,0,1985,0
1490,8366,0,0,4,1010,480,1975,0
2000,7000,0,0,3,2000,0,1916,1986
1030,4400,0,0,3,1030,0,1924,2011
720,6687,0,0,3,720,0,1942,1999
2020,5000,0,0,4,2020,0,1938,0
1580,8151,0,1,4,1100,480,1962,0
2110,13850,0,0,3,2110,0,1987,2000
1300,7054,0,0,3,1300,0,1950,2013
1630,7475,0,1,3,1160,470,1940,1996
3370,8103,0,3,3,1970,1400,1970,2014
1890,6156,0,0,3,980,910,1980,0
1520,7983,0,0,5,1520,0,1967,0
900,5160,0,0,3,900,0,1952,2008
1050,6874,0,0,3,1050,0,1954,2005
1260,6500,0,0,4,1260,0,1966,0
3470,117612,0,0,3,3470,0,1924,2011
2290,12047,0,0,4,2290,0,1988,0
2810,23400,0,1,3,1710,1100,1958,2004
1650,13816,0,0,3,1650,0,1998,2006
1640,14374,0,0,4,1140,500,1963,0
1850,10109,0,0,3,1850,0,1991,0
2000,5390,0,0,3,2000,0,2003,0
1410,9647,0,0,3,1410,0,1961,2004
1500,11600,0,0,4,1000,500,1955,2009
2460,54885,0,0,4,2460,0,1980,0
1010,7034,0,0,3,1010,0,1954,2005
1230,929,0,0,3,1020,210,2004,2003
2331,3826,0,0,3,2331,0,2007,0
2240,7770,0,0,3,1340,900,1978,0
2450,10117,0,0,5,1580,870,1967,0
3100,15480,0,0,3,2400,700,1996,0
2060,5000,0,0,3,1030,1030,1949,2013
1850,7684,0,0,3,1320,530,1979,2014
1840,10720,0,0,3,960,880,1958,2004
3740,32417,0,0,3,3740,0,2000,0
1420,8580,0,0,3,1420,0,1962,2003
1510,6083,0,0,4,860,650,1940,2001
2130,6500,0,2,3,1170,960,1954,2005
3490,6906,0,0,4,2280,1210,1928,0
1630,11800,0,0,4,1630,0,1971,0
1790,7167,0,0,3,1790,0,1989,0
2000,5684,0,0,3,2000,0,1996,0
2260,29930,0,0,4,1400,860,1977,0
3030,7864,0,0,3,3030,0,1999,0
1310,8160,0,0,3,1310,0,1950,2005
3880,14550,0,0,3,3880,0,1987,2000
3760,10920,0,0,5,2400,1360,1950,0
3040,8111,0,0,3,3040,0,1984,0
2910,9636,0,0,4,1690,1220,1964,0
2970,11985,0,0,3,1770,1200,1995,0
1660,6000,0,0,3,1160,500,1942,1999
3200,12369,0,0,3,3200,0,1998,2006
2680,18768,0,0,5,2680,0,1965,0
1230,9568,0,0,5,1230,0,1962,0
2740,45732,0,0,3,2740,0,1995,0
3380,8330,0,0,3,3380,0,2000,0
1110,6250,0,0,3,1110,0,1956,2001
1800,3780,0,0,3,1400,400,1926,2003
1900,5520,0,0,3,1280,620,1982,0
930,36478,0,2,3,930,0,1951,1994
1690,7735,0,0,4,1060,630,1976,1992
1420,4080,0,0,3,1420,0,1905,2013
4510,15175,0,0,3,4510,0,1969,2002
1980,8000,0,0,4,1560,420,1974,0
1170,2400,0,0,4,740,430,1903,0
2200,1970,0,0,3,1610,590,2008,0
800,8850,0,0,4,800,0,1959,0
1480,1171,0,0,3,1480,0,2006,0
2890,5000,0,0,3,1310,1580,2006,0
2690,4047,0,0,3,2690,0,2014,0
3569,8327,0,0,3,3569,0,2013,1923
1270,1320,0,0,3,1270,0,2006,0
4490,10279,0,0,3,3930,560,2013,1923
3040,6425,0,0,3,3040,0,2008,0
1170,1249,0,0,3,1170,0,2014,0
2060,8632,0,0,3,1030,1030,1962,2003
990,6000,0,0,3,990,0,1943,2002
2430,5203,0,0,3,2430,0,2003,0
4460,103382,0,0,3,4460,0,2001,0
1250,10122,0,0,3,1250,0,1994,0
1540,6760,0,0,5,1210,330,1980,0
1600,7000,0,0,4,1600,0,1993,0
1110,8423,0,0,3,1110,0,1952,2008
1840,10723,0,0,4,1220,620,1974,0
2520,5401,0,0,4,1360,1160,1946,1989
2680,327135,0,0,3,2680,0,1995,0
3830,6988,0,0,3,2450,1380,1938,2003
2410,9549,0,0,4,1780,630,1956,0
1720,10018,0,0,5,1720,0,1960,0
2070,37904,0,0,4,1420,650,1973,0
1760,9055,0,0,4,1760,0,1985,0
1680,10500,0,0,4,1680,0,1959,0
1550,2400,0,0,4,1550,0,1900,1971
4120,60392,0,2,3,3180,940,1994,0
1830,9548,0,0,3,1830,0,1991,0
1400,7410,0,0,3,1400,0,1944,0
1870,12381,0,0,4,1870,0,1957,2001
6210,8856,0,2,5,4760,1450,1910,0
1040,3500,0,0,4,1040,0,1904,0
2720,149410,0,0,3,2720,0,1988,2000
1010,9360,0,0,3,1010,0,1981,2013
1580,9147,0,1,4,1210,370,1967,0
2600,6050,0,0,5,1960,640,1949,0
1920,9180,0,0,3,1920,0,1988,2000
2350,5080,0,0,3,1780,570,1929,0
1100,4373,0,0,2,820,280,1947,0
2510,13695,0,0,4,1280,1230,1961,2001
3240,108366,0,0,4,3240,0,1991,0
2460,108900,0,0,4,1860,600,1977,0
1010,3885,0,0,4,1010,0,1906,1990
820,2723,0,0,3,820,0,1921,2000
2420,8560,0,2,3,1620,800,1978,0
1770,8165,0,0,3,1770,0,1977,2004
1350,3900,0,0,3,1350,0,2003,0
1960,4788,0,0,4,1090,870,1920,0
3305,16164,0,0,5,2245,1060,1922,1956
2550,5663,0,0,3,1720,830,2011,0
4130,226076,0,0,3,3170,960,1985,0
2310,13300,0,0,3,1890,420,1950,2005
1650,5000,0,0,3,1650,0,1955,2005
2650,4316,0,0,3,1520,1130,1905,2013
1890,5940,0,1,3,1470,420,1963,2008
2190,8000,0,0,4,2190,0,1967,0
2030,6500,0,0,3,2030,0,1988,2000
2270,5175,0,0,3,2130,140,2002,0
1610,4160,0,0,4,1010,600,1917,0
760,3001,0,0,3,760,0,1913,1983
1640,17335,0,0,3,840,800,1978,0
1630,12295,0,0,4,1630,0,1985,0
3560,6480,0,0,4,3560,0,1914,1945
2960,5500,0,2,3,2440,520,1937,1990
1940,37565,0,0,4,1940,0,1987,0
1410,7566,0,0,3,1410,0,1985,0
1040,16986,0,0,4,1040,0,1968,0
820,6400,0,0,4,820,0,1944,0
910,22000,0,0,3,910,0,1956,2001
3700,7647,0,1,3,3700,0,1948,1984
2180,11200,0,0,4,2180,0,1968,0
1600,4271,0,0,3,1600,0,2000,0
1500,6180,0,0,4,1060,440,1947,1988
1340,4284,0,0,3,1080,260,1910,2006
1860,13374,0,0,3,1860,0,1985,0
2540,7200,0,3,4,1600,940,1905,0
1040,13100,0,0,5,1040,0,1912,0
1380,11130,0,0,3,1380,0,1960,2012
1640,10762,0,0,3,1130,510,1988,2000
3000,6000,0,0,5,1500,1500,1958,0
2140,13000,0,0,3,1320,820,1968,1997
1760,6428,0,0,4,980,780,1942,1982
1660,8307,0,0,4,1660,0,1961,2001
1830,13042,0,0,3,1830,0,1990,2009
2210,8556,0,1,4,1210,1000,1954,1979
1490,6600,0,0,3,1490,0,1969,2010
1260,1270,0,0,3,1040,220,2005,0
4270,8076,0,0,3,3400,870,2007,0
3900,8391,0,0,3,3900,0,2006,0
1150,1027,0,0,3,1150,0,2008,0
2656,21195,0,0,3,2656,0,2014,0
2410,5003,0,0,3,1410,1000,2008,0
1606,1452,0,0,3,1606,0,2009,0
820,681,0,0,3,820,0,2006,0
1540,6872,0,0,4,820,720,1946,1989
2090,8354,0,0,3,2090,0,2012,1912
3160,11470,0,0,4,1780,1380,1971,0
1730,8320,0,0,3,1230,500,1977,2004
1670,4080,0,0,3,1170,500,1967,2011
2550,4630,0,0,3,2550,0,2005,0
3040,9601,0,0,5,1970,1070,1968,0
1250,4620,0,0,4,1150,100,1900,1971
2020,6236,0,0,3,2020,0,2002,0
2660,5500,0,2,3,2660,0,2003,0
980,5000,0,0,3,980,0,1922,2003
1960,8000,0,0,4,1290,670,1977,0
720,5040,0,0,3,720,0,1955,2005
1360,1349,0,0,3,1050,310,1997,0
1870,4950,0,0,3,1870,0,2006,0
2130,8800,0,0,3,1100,1030,1962,2003
1810,6509,0,0,3,1810,0,1994,0
2200,89298,0,0,3,1100,1100,1973,2013
1690,4500,0,1,4,1690,0,1928,0
1940,8547,0,0,3,1460,480,1989,0
2320,6270,0,0,3,2320,0,2004,2003
2060,26036,0,0,4,1160,900,1947,1988
3410,5000,0,0,5,2190,1220,1910,0
2250,41688,0,0,3,2250,0,1980,0
1390,7399,0,0,4,1390,0,1975,0
1060,4960,0,0,3,1060,0,1926,2003
1490,8995,0,0,4,1490,0,1954,1979
2480,9195,0,0,3,1390,1090,1950,2005
2440,20828,0,0,4,2440,0,1975,0
2240,87625,0,0,2,1480,760,1980,0
1920,7229,0,0,3,1920,0,1993,0
1890,9920,0,0,3,1230,660,1944,0
2250,13515,0,0,4,2150,100,1940,2001
1270,3008,0,0,4,650,620,1923,0
960,1808,0,0,3,960,0,1993,0
3290,6465,0,0,3,3290,0,2002,0
2000,6120,0,0,3,1100,900,1965,1993
1020,8155,0,0,4,1020,0,1948,0
1840,9600,0,0,3,1220,620,1967,2011
1980,6760,0,0,4,1980,0,1973,0
3510,5760,0,0,4,3510,0,1906,1990
1230,3600,0,0,5,1230,0,1925,0
2280,65836,0,0,3,2280,0,2004,2003
2430,12757,0,2,4,1340,1090,1952,0
2920,3942,0,0,3,2920,0,2008,0
2280,2850,0,0,4,1540,740,1930,0
1510,43560,0,0,3,1510,0,1954,2005
950,6000,0,0,3,790,160,1939,1969
1190,3000,0,0,3,1190,0,2002,0
1310,9282,0,0,4,1310,0,1976,1992
2800,3200,0,0,5,1910,890,1932,2002
1750,3354,0,0,4,1750,0,1991,0
1320,5750,0,0,5,1320,0,1918,0
2460,7350,0,0,3,2460,0,1989,0
1240,10800,0,0,3,1240,0,1967,2010
1260,7964,0,0,4,1260,0,1955,2009
2820,15600,0,2,5,1970,850,1940,0
3820,24166,0,1,4,3310,510,1990,0
1540,1614,0,0,3,1470,70,2008,0
1550,435600,0,0,2,1550,0,1972,0
1460,7700,0,0,3,1460,0,1979,2014
1390,16000,0,0,4,1390,0,1960,2001
2640,4080,0,0,3,1840,800,1912,2000
1590,9620,0,0,3,1590,0,1988,2000
1910,6960,0,0,5,1910,0,1941,0
2015,16807,1,4,3,2015,0,2007,0
1410,1197,0,0,3,1410,0,2012,1912
1110,957,0,0,3,930,180,2005,0
860,1277,0,0,3,860,0,2007,0
2310,4729,0,0,3,2310,0,2011,0
1020,1060,0,0,3,1020,0,2008,0
980,1179,0,0,3,980,0,2010,0
4230,37769,0,0,3,4230,0,1989,0
1640,11050,0,0,4,1640,0,1972,0
3810,13592,0,1,3,2560,1250,2013,1923
2790,10819,0,0,3,2790,0,1996,0
1750,5500,0,0,5,1050,700,1926,0
1430,8355,0,0,4,1430,0,1983,0
1850,4597,0,0,3,1850,0,2003,0
960,28717,0,0,4,960,0,1984,0
2480,45302,0,0,4,1620,860,1976,1992
3750,11025,0,0,3,3750,0,1976,0
2600,11951,0,0,3,2600,0,1988,2000
1390,8700,0,3,4,840,550,1912,1989
2260,7753,0,0,3,2260,0,1989,0
2470,7447,0,0,3,2470,0,1984,0
810,7980,0,0,1,810,0,1928,0
1650,6000,0,0,5,1000,650,1959,0
3000,11665,1,4,3,3000,0,2001,0
720,18000,0,0,3,720,0,1950,2005
1390,48257,0,0,3,1390,0,1922,2013
1445,1606,0,0,3,1300,145,2003,0
1840,3300,0,0,4,1130,710,1910,0
2100,5824,0,2,3,2100,0,1999,0
1060,10464,0,0,4,1060,0,1973,0
1500,6337,0,0,5,1500,0,1953,0
1970,7213,0,0,3,1170,800,1977,2004
1410,1253,0,0,3,1410,0,2005,0
3720,9450,0,4,5,1960,1760,1962,0
2190,14439,0,0,4,1180,1010,1977,0
1920,8075,0,0,4,1510,410,1969,0
1160,8320,0,0,4,1160,0,1959,0
5860,52889,0,0,4,4910,950,1996,0
2000,4000,0,0,5,1450,550,1926,0
2163,5883,0,0,3,2163,0,2006,0
3480,57499,0,0,4,2340,1140,1976,1992
2840,6268,0,0,3,2840,0,1998,2006
1150,4400,0,0,4,1150,0,1905,0
3100,3773,0,0,3,2000,1100,1919,1996
1420,14850,0,0,4,1020,400,1963,0
2430,32496,0,0,3,2430,0,1993,0
1930,7452,0,0,3,1430,500,1984,0
1660,10140,0,0,4,1370,290,1980,0
1400,7293,0,0,4,1400,0,1963,0
2660,4000,0,0,3,2660,0,2001,0
2000,13300,0,0,4,1200,800,1968,0
2130,8078,0,0,4,1380,750,1977,0
1352,1694,0,0,3,1352,0,2007,0
1750,11340,0,1,4,1300,450,1987,0
2320,8100,0,0,4,1160,1160,1956,0
1420,81892,0,0,3,1180,240,1956,2001
1940,3784,0,0,3,1940,0,2003,0
1410,4800,0,0,3,1410,0,1940,1996
1360,9948,0,0,3,1360,0,1977,2004
1220,7250,0,0,3,1220,0,1962,2003
2830,20345,0,0,3,1980,850,1979,2014
3780,10308,0,0,3,3780,0,1999,0
2330,14289,0,0,4,2330,0,1978,2000
3560,107290,0,0,3,3560,0,1987,2000
1470,70800,0,0,3,1470,0,1976,0
3060,48787,0,0,3,3060,0,1992,0
1030,6127,0,0,3,880,150,1947,2012
1930,9653,0,0,4,1930,0,1968,0
1780,120661,0,0,4,1780,0,1979,0
2000,9202,0,0,4,2000,0,1992,0
1690,9583,0,0,4,1690,0,1969,0
5190,23716,0,2,3,3390,1800,1987,2000
1300,5413,0,0,3,1300,0,1925,1992
2400,29252,0,0,4,2400,0,1982,2011
1150,6634,0,0,3,860,290,1940,1996
2310,7490,0,0,3,2310,0,1980,0
2730,3047,0,0,3,2400,330,2006,0
2840,4500,0,0,3,2840,0,2012,1912
1020,1525,0,0,3,1020,0,2004,2003
1340,1384,0,0,3,1340,0,2008,0
3540,159430,0,0,3,3540,0,2007,0
7270,130017,0,0,3,6420,850,2010,0
998,904,0,0,3,798,200,2007,0
3060,7015,0,0,5,1600,1460,1979,0
2130,6969,0,0,3,2130,0,2003,0
2520,6000,0,0,3,1400,1120,1921,2007
1940,9533,0,0,3,1080,860,1962,2003
1350,1250,0,0,3,1270,80,2006,0
2160,5298,0,0,4,2160,0,1902,0
1370,1350,0,0,3,1010,360,2007,0
5420,101930,0,0,3,3890,1530,2001,0
2830,5000,0,0,3,2830,0,1995,0
2010,2287,0,0,3,1390,620,2014,0
3300,12090,0,0,3,3300,0,1953,0
1230,1391,0,0,3,870,360,2004,2003
1720,7119,0,0,4,1720,0,1952,0
810,2451,0,0,5,810,0,1941,0
1560,8078,1,4,4,1560,0,1928,0
2560,216777,0,0,3,2560,0,1986,0
4700,38412,0,0,3,3420,1280,1978,0
1220,2500,0,0,3,770,450,1910,2006
3650,20150,0,0,4,2360,1290,1975,0
2170,12508,0,0,5,1650,520,1928,1970
2540,228254,0,0,3,1450,1090,1990,2009
910,4500,0,0,4,910,0,1906,1990
2980,4930,0,0,3,2890,90,2000,0
2120,4650,0,1,3,1190,930,1951,1994
3460,3997,0,0,3,2560,900,2004,2003
2480,10090,0,0,3,1300,1180,2004,2003
2200,16921,0,0,3,2200,0,1987,2000
1730,5500,0,0,5,1010,720,1943,0
2920,34527,0,4,4,1800,1120,1954,1983
990,8012,0,0,4,990,0,1966,0
3040,6887,0,0,3,3040,0,1999,0
4530,258746,0,0,4,3200,1330,2003,0
1370,8470,0,0,4,1370,0,1961,2001
1940,4927,0,0,3,1940,0,2004,2003
1040,2643,0,0,3,720,320,2004,2003
1800,8623,0,0,4,1360,440,1980,0
1720,5000,0,0,3,1720,0,1954,2014
980,6380,0,0,3,760,220,1941,1994
3110,6142,0,0,3,3110,0,2004,2003
2100,7715,0,0,3,1250,850,2013,1923
2020,11358,0,0,4,1190,830,1956,0
2350,11914,0,0,4,2350,0,1961,2001
3290,12329,0,0,4,3290,0,1968,0
2180,7813,0,0,3,2180,0,1986,0
1290,1334,0,0,3,1290,0,2007,0
1460,9750,0,0,4,1460,0,1969,0
1290,2828,0,0,3,1290,0,2008,0
2350,3150,0,0,4,1690,660,1910,0
1080,8100,0,0,4,1080,0,1955,2009
2670,13463,0,0,4,2670,0,1989,0
3680,5759,0,0,3,2840,840,2003,0
1440,8040,0,0,3,960,480,1951,1994
1940,4800,0,0,5,1030,910,1922,1956
1280,9898,0,0,3,1280,0,1968,1997
2980,27144,1,2,5,2180,800,1917,0
970,8580,0,0,3,970,0,1959,1989
2110,5000,0,2,4,1640,470,1930,0
1480,1369,0,0,3,1480,0,2009,0
700,10540,0,0,3,700,0,1953,0
2700,6120,0,0,4,1350,1350,1962,0
2330,9687,0,3,3,2330,0,1918,0
3380,20021,0,0,4,1690,1690,1963,0
2600,2750,0,0,3,1620,980,1936,0
1360,8100,0,0,3,860,500,1975,0
2780,6369,0,0,3,1590,1190,1978,0
1250,53143,0,0,5,1250,0,1945,0
2620,8950,0,0,3,2620,0,1992,0
1350,7620,0,0,5,1350,0,1941,0
2400,3340,0,0,4,1200,1200,1964,0
2760,5000,0,0,5,1680,1080,1928,1970
3070,16028,0,3,3,1870,1200,1976,0
2040,28593,1,3,4,2040,0,1919,1990
1770,6000,0,0,5,1770,0,1911,1981
3490,9170,0,0,3,3490,0,2012,1912
830,1333,0,0,3,830,0,2005,0
980,895,0,0,3,670,310,2009,0
1570,1433,0,0,3,1570,0,2010,0
3270,5187,0,0,3,3110,160,2014,0
2160,6223,0,0,3,2160,0,2010,0
3280,11000,0,0,3,2320,960,2008,0
3360,7685,0,0,3,3360,0,2001,0
3150,7119,0,0,3,3150,0,2013,1923
1810,1846,0,0,4,1440,370,2009,0
2740,7140,0,0,3,2740,0,1993,0
3830,35000,0,0,3,2130,1700,1976,0
3190,5283,0,0,3,3190,0,2007,0
2350,10450,0,0,3,1390,960,1977,2004
2510,8165,0,0,4,1610,900,1972,0
1680,4950,0,0,3,1680,0,2006,0
1770,6610,0,0,4,960,810,1954,1979
1090,7315,0,0,5,1090,0,1981,0
3001,5710,0,0,3,3001,0,2006,0
2450,4591,0,0,3,2450,0,1994,0
3610,59677,0,0,3,2440,1170,2003,0
2250,7500,0,0,5,1200,1050,1956,0
1240,7735,0,0,4,1240,0,1957,2001
2260,6000,0,0,3,1430,830,1958,2004
2090,8164,0,0,4,1070,1020,1963,0
2020,7902,0,0,3,1220,800,1962,2003
1960,5000,0,0,5,980,980,1911,1984
3120,16672,0,0,4,3120,0,1969,0
1250,7500,0,0,3,1250,0,1967,2011
1490,9600,0,0,4,1170,320,1987,0
2890,2370,0,0,3,2290,600,1906,2014
1900,33888,0,0,4,1900,0,1942,1982
1680,2400,0,0,5,870,810,1922,1956
2030,8398,0,0,4,2030,0,1975,0
3740,8700,0,0,3,2260,1480,2004,2003
1580,11750,0,0,4,1180,400,1951,1999
1780,6120,0,0,4,1390,390,1927,0
910,6232,0,0,3,910,0,1943,2002
3440,8100,0,0,3,3440,0,1970,2014
1740,13750,0,0,4,1740,0,1975,0
3400,8970,0,0,4,1700,1700,1959,0
4400,16625,0,0,3,4400,0,2003,0
2010,14298,0,0,3,2010,0,1977,2004
2710,38180,0,0,4,2710,0,1977,0
5300,26211,1,2,2,4570,730,1923,0
1310,3880,0,0,3,1090,220,1956,2001
1950,12559,0,0,3,1950,0,1939,1969
1040,6535,0,0,3,1040,0,1947,2012
1090,7200,0,0,3,1090,0,1968,1997
650,5360,0,0,4,650,0,1931,0
1480,6600,0,2,3,740,740,1943,2002
790,2640,0,0,3,790,0,1973,2013
3560,11119,0,2,3,2290,1270,1986,0
3000,5548,0,0,3,3000,0,2006,0
3490,7494,0,3,3,3490,0,2000,0
2340,10495,0,0,4,2340,0,1967,0
1650,8254,0,0,5,1060,590,1951,0
1940,5820,0,0,5,1150,790,1944,0
3410,9600,0,0,4,1870,1540,1968,0
1710,4050,0,0,3,1710,0,1909,2004
2740,4000,0,0,5,1930,810,1905,0
1250,892,0,0,3,1040,210,2010,0
2450,42180,0,0,4,2450,0,1978,2000
1690,8190,0,0,4,1690,0,1958,1972
1950,13320,0,0,4,1370,580,1969,0
2290,7125,0,0,3,1190,1100,1964,2000
3370,17458,0,2,5,2000,1370,1982,0
1090,8640,0,0,4,1090,0,1973,0
1190,9486,0,0,4,1190,0,1953,1983
3530,7924,0,0,3,3530,0,2001,0
1440,5000,0,0,3,1440,0,1910,2006
2180,13529,0,0,3,1090,1090,1956,2001
1410,6000,0,0,3,810,600,1925,2002
1950,8251,0,0,3,1950,0,1990,2009
4860,23723,0,2,4,3820,1040,1989,0
1660,7210,0,0,3,1100,560,1963,2008
1390,12823,0,0,4,1390,0,1968,0
1350,14200,0,0,3,1350,0,1989,0
1530,5401,0,0,4,1530,0,1937,0
1270,5112,0,0,3,1270,0,1950,2005
2140,6355,0,0,3,2140,0,2002,0
2040,5616,0,0,3,2040,0,2012,1912
2876,5086,0,0,3,2360,516,2007,0
1580,1161,0,0,3,1010,570,2008,0
3400,5196,0,0,3,3400,0,2012,1912
3520,6773,0,0,3,2650,870,2006,0
2210,4861,0,0,3,2210,0,2013,1923
2790,5602,0,0,3,2790,0,2009,0
1450,5008,0,0,3,840,610,2007,0
1620,4980,0,0,4,860,760,1947,1988
1220,1086,0,0,3,1220,0,2007,0
2000,5000,0,0,4,1110,890,1921,0
2190,7350,0,0,5,2190,0,1958,0
1900,8250,0,0,4,950,950,1955,2009
1700,4400,0,0,4,1700,0,1906,1990
2540,3832,0,0,5,1760,780,1929,0
1170,8925,0,2,3,1170,0,1911,1979
5774,31675,0,2,3,4490,1284,1984,0
2120,15003,0,0,3,2120,0,1984,0
2170,26460,0,0,3,1450,720,1986,0
2450,15002,0,0,5,2450,0,1974,0
700,5200,0,0,5,700,0,1952,1998
1780,7214,0,0,4,1400,380,1986,0
1850,8250,0,0,4,1150,700,1952,0
1570,5706,0,0,3,1570,0,1998,2006
1290,5500,0,0,3,980,310,1951,1994
1700,7314,0,0,3,1000,700,1956,2001
1159,4800,0,0,3,1159,0,1948,1994
1850,9600,0,0,5,1850,0,1965,0
840,3522,0,0,3,840,0,1947,2012
1690,1618,0,0,3,1150,540,2014,0
1050,9876,0,0,3,1050,0,1953,0
1400,3825,0,0,4,1100,300,1904,0
2550,7200,0,2,3,2550,0,1981,2013
1840,5011,0,0,3,1840,0,2012,1912
2360,6750,0,0,5,1930,430,1926,0
2240,14667,0,0,4,2240,0,1989,0
2700,4004,0,0,3,2700,0,2004,2003
3030,30007,0,0,4,3030,0,1992,0
1830,5120,0,2,5,1830,0,1903,0
2220,6049,0,0,4,2220,0,1990,0
2090,7640,0,0,3,1360,730,1962,2014
1600,6120,0,0,3,1600,0,1924,2011
2010,8625,0,0,4,1340,670,1957,2001
830,4000,0,0,3,830,0,1955,2005
2010,7226,0,0,3,2010,0,1995,0
1050,5402,0,0,4,1050,0,1906,1990
2150,39449,0,0,3,1420,730,1978,0
860,11900,0,0,4,860,0,1963,0
3100,20553,0,0,3,3100,0,1954,2005
1100,17334,0,0,3,1100,0,1978,0
1830,8000,0,0,4,1830,0,1957,2001
1250,34395,0,0,4,1250,0,1950,1983
1820,4883,0,0,3,1820,0,2005,0
2090,42689,0,0,3,2090,0,1959,1998
2100,12384,0,0,3,2100,0,1980,0
2310,14023,0,0,3,2310,0,1991,0
2060,5649,0,0,5,1360,700,1941,0
4470,60373,0,0,3,4470,0,1988,2000
1660,7500,0,0,4,1060,600,1940,2001
3810,8019,0,0,3,3810,0,2008,0
2110,10200,0,0,4,2110,0,1966,0
2370,217800,0,0,3,1600,770,1992,0
1970,3716,0,0,3,1970,0,1997,0
2470,33305,0,0,3,2470,0,1993,0
1480,7830,0,0,3,1480,0,1952,2008
2257,10117,0,0,3,1363,894,2005,0
700,6000,0,0,4,700,0,1949,1985
1630,9010,0,0,4,1050,580,1975,0
3430,10157,0,0,3,3430,0,2000,0
2220,6000,0,0,3,1420,800,1923,1998
1340,7473,0,0,4,1340,0,1973,0
980,2130,0,0,4,860,120,1918,1974
2580,13096,0,0,3,2580,0,1986,0
2230,4541,0,0,3,2230,0,2006,0
2290,11137,0,0,4,2290,0,1955,2009
1260,8280,0,0,3,1260,0,1946,0
1680,11180,0,0,4,1680,0,1966,0
3200,7081,0,0,3,3200,0,2004,2003
3320,7644,0,0,3,3320,0,1995,0
3040,24123,0,0,3,3040,0,1999,0
2270,7375,0,0,4,1290,980,1973,0
2910,17172,0,0,3,2910,0,1989,0
2510,9887,0,0,3,2510,0,1972,2002
1240,7200,0,0,3,1240,0,1967,2011
2580,5200,0,0,3,2580,0,2008,0
2470,3600,0,0,3,2470,0,2007,0
4910,9444,0,0,3,3110,1800,2007,0
1690,5025,0,0,3,1690,0,2003,0
2240,12032,0,0,3,2240,0,1983,2009
1650,7352,0,0,3,1160,490,1979,2014
2710,5880,0,0,3,2710,0,1998,2006
1260,10350,0,0,3,1260,0,1959,1989
1150,8100,0,0,3,1150,0,1932,0
2550,7636,0,0,3,1440,1110,1986,0
1490,6930,0,0,4,1490,0,1990,0
2020,7865,0,0,4,1010,1010,1963,0
1320,4520,0,1,3,1320,0,1912,1971
1230,10350,0,0,4,1230,0,1957,2001
2070,7800,0,0,3,2070,0,1989,0
2930,11562,0,3,3,1670,1260,1947,2012
1090,8520,0,0,3,1090,0,1967,2011
1400,7066,0,0,3,1400,0,1957,2000
1550,4815,0,0,3,1550,0,1909,2004
1220,13000,0,0,4,1220,0,1955,2009
1870,7344,0,0,3,1470,400,1980,0
2150,30476,0,0,3,2150,0,1991,0
980,3090,0,0,3,980,0,1903,2005
1490,8475,0,0,4,1490,0,1963,0
1120,7000,0,0,3,1120,0,1955,2005
1180,9630,0,0,3,1180,0,1986,0
3240,20301,0,0,3,3240,0,1985,0
2150,6807,0,0,4,2150,0,1991,0
2240,10800,0,0,3,2240,0,1996,0
1400,7384,0,0,3,1150,250,1979,2014
1980,40887,0,0,4,1980,0,1980,0
1330,20562,0,0,3,1330,0,1959,1989
3200,7535,0,0,3,3200,0,2006,0
1490,6000,0,0,3,1090,400,1946,0
3920,16258,0,0,3,2900,1020,1990,2009
2000,3750,0,0,4,2000,0,1921,0
2680,9185,0,0,3,2680,0,1989,0
1670,9987,0,0,3,1670,0,1967,2011
3150,9130,0,0,3,3150,0,2001,0
2740,7266,0,0,3,2060,680,2003,0
1890,8000,0,0,4,1250,640,1960,2001
2870,29699,0,0,3,1520,1350,1961,2004
1160,10384,0,0,4,1160,0,1969,0
3550,19865,0,0,3,3550,0,1962,2002
1790,6117,0,2,3,1350,440,1940,1996
1680,250470,0,0,4,1070,610,1940,2001
4560,17622,0,0,4,3800,760,1986,0
1590,7748,0,0,4,1590,0,1991,0
1630,10304,0,0,5,1630,0,1953,0
2700,7434,0,0,3,2700,0,1991,0
1700,7496,0,0,3,1700,0,1994,0
3740,12080,0,0,3,2000,1740,1988,2000
1980,5352,0,0,3,1980,0,1941,2005
880,6345,0,0,3,880,0,1919,2001
1400,6200,0,0,3,700,700,1948,1994
2050,4000,0,0,5,1210,840,1941,0
2360,4638,0,3,3,2360,0,1996,0
2560,7798,0,0,4,1890,670,1947,1988
1340,10224,0,0,4,1340,0,1956,0
1060,5200,0,0,5,1060,0,1970,0
850,2500,0,0,3,850,0,1986,0
1880,7303,0,0,3,1010,870,1976,0
1230,12305,0,0,3,1230,0,1955,1990
2290,10290,0,0,3,1340,950,1960,2012
1660,6582,0,0,5,1000,660,1946,0
1840,2875,0,0,4,1840,0,1997,0
3020,17810,0,0,3,1600,1420,1979,2014
1410,6886,0,0,3,1410,0,1924,2013
1010,9514,0,0,3,1010,0,1969,2010
1960,8136,0,0,3,980,980,1948,1994
3580,14275,0,0,3,3190,390,1999,0
2240,7200,0,0,3,2240,0,1995,0
3310,5404,0,0,3,3310,0,2004,2003
1232,1130,0,0,3,1232,0,2007,0
3930,5680,0,1,3,2820,1110,2013,1923
1720,3600,0,0,3,1720,0,2010,0
1490,974,0,0,3,1220,270,2009,0
3150,151588,0,0,3,3150,0,2007,0
3950,10856,0,0,3,3950,0,2013,1923
3030,10335,0,0,3,3030,0,2013,1923
1070,9643,0,0,3,1070,0,1985,0
2320,36847,0,2,3,2320,0,1992,0
700,5100,0,0,3,700,0,1942,1999
2720,6439,0,0,3,2720,0,2005,0
1800,5761,0,0,4,1800,0,1990,0
1560,4049,0,2,3,1000,560,1926,2003
1760,11410,0,0,5,1060,700,1977,0
3120,5000,0,0,3,2370,750,2005,0
2020,7200,0,3,4,1700,320,1947,1988
1450,2400,0,0,3,1450,0,1900,2003
1860,7000,0,0,3,1120,740,1979,2014
2270,7800,0,0,3,1290,980,1977,2004
1480,15639,0,0,3,1480,0,1987,2000
1460,6032,0,0,4,1460,0,1941,1998
1850,6519,0,0,3,1130,720,1986,0
2170,5000,0,0,3,2170,0,2003,0
1726,197326,0,0,4,1726,0,1982,2011
1180,10541,0,0,4,940,240,1981,0
1370,9957,0,0,3,900,470,1972,2002
2670,13218,0,0,4,2670,0,1988,0
1260,6826,0,0,3,720,540,1944,0
1980,7991,0,0,3,1980,0,1962,2003
2050,3933,0,0,3,1180,870,1926,2001
2830,5310,0,0,3,2830,0,2006,0
910,3600,0,0,4,910,0,1909,1989
2440,4000,0,0,3,2440,0,2009,0
2180,5440,0,0,5,1100,1080,1904,0
1900,6660,0,0,5,950,950,1966,0
1520,1221,0,0,3,1520,0,2013,1923
2220,6641,0,2,4,1220,1000,1947,1988
3280,24440,0,0,3,3280,0,1996,0
2740,83199,0,4,3,2740,0,1973,2013
830,6017,0,0,4,830,0,1954,1979
1010,5200,0,0,3,1010,0,1955,2005
2060,38377,0,0,4,1560,500,1978,2000
1990,7340,0,0,3,1990,0,1984,0
2280,7568,0,0,4,2280,0,2001,0
1870,5874,0,0,3,1870,0,2005,0
1720,4000,0,0,4,1450,270,1921,0
870,6150,0,0,3,870,0,1941,1994
1020,1204,0,0,3,720,300,2004,2003
1260,3135,0,0,3,1260,0,1931,0
2370,7875,0,0,3,2370,0,2003,0
1000,18513,0,0,3,1000,0,1940,1996
1100,1751,0,0,3,940,160,2007,0
1440,7673,0,0,3,940,500,1982,0
3120,14300,0,0,3,3120,0,2003,0
2260,9604,0,0,3,2260,0,1990,2009
2790,7956,0,0,3,2790,0,2005,0
1140,6700,0,0,3,1140,0,1920,1979
1290,2500,0,0,4,1290,0,1987,0
1730,5200,0,0,4,1050,680,1978,2000
3160,11380,0,0,3,3160,0,1983,2009
2340,8990,0,0,3,2340,0,2003,0
1170,4950,0,0,4,1170,0,1960,2001
1160,5000,0,0,4,1160,0,1937,0
1970,24318,0,0,3,1970,0,2010,0
6490,10862,0,3,4,3940,2550,1991,0
1410,1377,0,0,3,1290,120,2005,0
2430,5000,0,0,3,2430,0,2009,0
3360,5402,0,0,3,3360,0,2014,0
1480,1663,0,0,3,1180,300,2012,1912
3200,6455,0,0,3,3200,0,2009,0
2134,1984,0,0,3,2134,0,2008,0
1860,1787,0,0,3,1860,0,2007,0
5520,8313,0,3,3,3570,1950,2008,0
1310,1500,0,0,3,1160,150,2006,0
1700,4250,0,0,3,890,810,1944,0
2480,8342,0,0,3,2480,0,1986,0
1970,8605,0,0,4,1970,0,1994,0
2060,7475,0,0,3,1440,620,1985,0
2130,3500,0,0,4,1210,920,1994,0
1410,14110,0,2,3,1170,240,1987,2000
1360,4688,0,0,3,780,580,1944,0
1940,55756,0,0,5,1940,0,1954,0
1610,2040,0,0,4,1610,0,1979,0
1420,9191,0,2,5,1420,0,1928,1970
1700,7280,0,0,4,1700,0,1988,0
1490,3825,0,0,3,860,630,1929,0
2680,7757,0,0,3,2680,0,1990,2009
3190,8684,0,3,5,1680,1510,1967,0
2120,7700,0,0,5,2120,0,1962,0
1690,3250,0,0,3,1550,140,1901,0
1830,8601,0,0,3,1830,0,2003,0
1010,1968,0,0,5,1010,0,1906,0
2070,9300,0,0,5,1120,950,1945,0
1710,4500,0,0,3,1410,300,1928,1954
1660,4690,0,0,3,1260,400,1945,2010
2080,13629,0,0,4,1040,1040,1955,2009
1270,9675,0,0,3,1270,0,1993,0
1080,21043,0,0,3,1080,0,1942,1999
1610,5100,0,0,5,1610,0,1940,0
1120,9912,0,0,4,1120,0,1980,0
2500,5257,0,0,3,2500,0,1966,1963
970,7275,0,0,4,970,0,1970,0
3370,5000,0,0,4,2140,1230,1907,0
1290,189486,0,0,4,1290,0,1960,2001
3370,435600,0,3,3,3370,0,2005,0
3410,10769,0,0,3,3410,0,2008,0
2490,8290,0,0,3,2490,0,1999,0
770,4000,0,0,5,770,0,1924,1956
810,3211,0,0,4,810,0,1982,2011
3060,10043,0,0,4,1700,1360,1968,0
1690,1613,0,0,3,1150,540,2014,0
1890,3825,0,0,3,1290,600,1974,0
1470,3128,0,0,3,1470,0,2005,0
1060,7193,0,0,3,1060,0,1926,2003
3480,59242,0,0,3,3480,0,1988,2000
2730,3560,0,0,3,1550,1180,1921,2007
1580,7941,0,0,4,1580,0,1986,0
2170,7900,0,0,4,1380,790,1978,2000
930,4743,0,0,4,930,0,1942,1982
1580,7800,0,0,2,1580,0,1906,0
3290,11900,0,0,3,3290,0,1973,2013
2110,10698,0,0,4,2110,0,1979,0
1670,3565,0,0,3,1670,0,1999,0
2030,7350,0,0,4,1190,840,1977,0
1500,4100,0,0,3,1370,130,1926,2003
1450,1445,0,0,3,980,470,2005,0
1310,8250,0,0,3,1060,250,1953,0
4180,49222,0,0,4,2880,1300,1979,0
1630,28600,0,0,3,1630,0,1967,2011
2660,10452,0,0,3,2660,0,1993,0
1720,1916,0,0,3,1720,0,2005,0
1260,1240,0,0,3,1260,0,2004,2003
1610,12247,0,0,3,1610,0,1981,2013
680,8064,0,0,3,680,0,1941,1994
2640,5900,0,2,3,2640,0,1937,1998
1640,7200,0,0,4,1640,0,1985,0
2310,8045,0,0,4,1650,660,1976,1992
2010,4905,0,0,5,1230,780,1912,0
1660,4680,0,0,5,830,830,1908,0
2200,3360,0,0,3,2200,0,2009,0
2460,4200,0,0,3,2460,0,1998,2006
2430,23400,0,4,3,2430,0,1951,1994
1370,7500,0,0,3,1370,0,1960,2012
1800,10200,0,0,3,1800,0,1967,2011
2200,7706,0,2,3,2200,0,1908,1988
700,2334,0,0,3,700,0,1945,2010
1920,15124,0,0,3,1920,0,1995,0
2190,12687,0,0,5,1370,820,1978,0
2030,9791,0,0,4,1500,530,1984,0
1350,2053,0,0,3,1350,0,2005,0
1680,2096,0,0,3,1380,300,2008,0
1250,10530,0,0,4,1250,0,1966,0
2240,6000,0,0,4,1270,970,1914,1945
950,7620,0,0,3,950,0,1954,2005
2320,3174,0,0,3,2060,260,1997,0
2380,9374,0,2,3,2380,0,2011,0
1540,958,0,0,3,1540,0,2007,0
2100,9752,0,0,3,1200,900,2007,0
2500,4945,0,0,3,2500,0,2013,1923
3230,7331,0,0,3,3230,0,2004,2003
2830,5802,0,0,3,2830,0,2001,0
870,5340,0,0,2,870,0,1906,0
2690,28300,0,0,3,2690,0,1954,1999
1260,889,0,0,3,1260,0,2008,0
2680,10000,0,0,3,2040,640,1942,2014
2660,4975,0,0,3,2660,0,2014,0
1480,5120,0,0,4,840,640,1951,1999
1770,33132,0,0,4,1190,580,1965,0
950,7692,0,0,3,950,0,1926,2003
860,8308,0,0,4,860,0,1948,0
1960,7560,0,0,5,1160,800,1978,0
1770,5522,0,0,4,960,810,1943,0
1280,6060,0,0,3,860,420,1926,2003
2150,12028,0,0,4,2150,0,1982,2011
1790,4000,0,0,4,1040,750,1923,0
1990,10260,0,0,4,1990,0,1987,0
2430,4781,0,0,3,2430,0,2001,0
2820,13193,0,0,3,1860,960,1965,1993
1910,8190,0,0,4,1010,900,1946,1989
1270,1213,0,0,3,1040,230,2005,0
2050,3960,0,0,4,1180,870,1986,0
2150,4505,0,0,3,1270,880,1952,2008
2450,13300,0,2,4,1630,820,1987,0
1230,1280,0,0,3,960,270,2012,1912
2260,41984,0,0,4,2260,0,1967,0
1050,60113,0,0,4,1050,0,1943,0
1570,7775,0,0,3,1570,0,1982,0
1820,9350,0,0,4,1820,0,1967,0
1540,4025,0,0,4,1190,350,1908,0
2060,44866,0,0,3,2060,0,1953,0
4380,74052,0,0,3,4380,0,2001,0
1090,9900,0,0,4,1090,0,1955,2009
1480,7225,0,0,4,1480,0,1965,0
1320,4440,0,0,3,1320,0,1929,0
2140,10350,0,0,3,1470,670,1976,0
4560,16643,0,3,3,2230,2330,1995,0
2800,9764,0,0,3,2800,0,2002,0
1050,5000,0,0,4,1050,0,1967,0
1490,9630,0,0,4,1490,0,1959,0
1730,6375,0,0,4,1730,0,1945,0
1210,3760,0,0,3,1210,0,1900,2005
2800,8494,0,0,3,2800,0,2004,2003
1570,1050,0,0,3,1570,0,1915,0
1400,31626,0,0,2,1140,260,1987,0
2850,7861,0,4,4,1450,1400,1970,0
1880,7200,0,0,4,1880,0,1966,0
790,8424,0,0,4,790,0,1953,1983
1300,4000,0,0,3,1300,0,1948,1994
2120,7735,0,0,4,1060,1060,1967,0
1540,4773,0,0,3,1540,0,1941,2009
2620,13777,0,2,4,1720,900,1926,1993
2880,3192,0,0,4,2180,700,1919,1985
1680,4021,0,0,3,1680,0,1921,2000
790,6969,0,0,3,790,0,1955,1984
1092,7500,0,0,3,1092,0,1918,0
1650,9936,0,0,3,1090,560,1967,2011
2090,4700,0,0,3,2090,0,2002,0
2180,28710,0,0,3,1180,1000,1950,2005
1990,6671,0,0,3,1990,0,1989,0
2650,7945,0,0,3,2650,0,2006,0
4460,16953,0,0,3,2550,1910,1962,1994
910,8000,0,0,4,740,170,1950,1983
2770,10773,0,2,3,2770,0,1992,0
2390,6888,0,1,5,2390,0,1939,0
3050,158558,0,0,4,3050,0,1987,0
1700,4000,0,0,3,1700,0,2003,0
3200,43560,0,0,3,3200,0,1989,0
1200,4500,0,0,5,1200,0,1906,0
2220,6953,0,0,4,2220,0,1999,0
2480,9041,0,0,3,2480,0,2004,2003
2560,12100,0,0,4,1760,800,1976,1992
2500,6300,0,0,4,1500,1000,1961,2001
1150,4000,0,0,3,1150,0,1947,2012
1650,7775,0,0,4,1150,500,1950,1983
1140,9628,0,0,4,1140,0,1969,0
3400,8965,0,2,5,1820,1580,1957,0
1180,43124,0,0,4,1180,0,1959,0
1700,4105,0,0,3,1700,0,1992,0
1240,11200,0,0,4,1240,0,1954,1979
2890,12478,0,0,3,2890,0,1977,2004
1060,10050,0,0,4,1060,0,1967,0
1590,10523,0,0,4,1590,0,1922,0
2860,5682,0,0,3,2860,0,1978,0
820,1060,0,0,3,760,60,2007,0
2020,8118,0,0,3,1020,1000,1963,2008
1870,9680,0,0,4,1170,700,1959,0
2170,4905,0,0,3,2170,0,2004,2003
1600,6765,0,0,3,830,770,1947,2011
2090,4300,0,0,4,1250,840,1925,1968
1700,6025,0,0,3,1700,0,1978,0
1940,6909,0,0,4,970,970,1941,1998
1320,8625,0,0,4,1320,0,1957,2001
3500,13875,0,4,4,1830,1670,1938,0
2800,5120,0,0,3,2800,0,1903,2005
1080,2940,0,0,4,1080,0,1920,0
3550,8048,0,0,3,3550,0,2007,0
2010,251341,0,0,3,1510,500,2003,0
1690,1468,0,0,3,1380,310,2008,0
1270,1443,0,0,3,1270,0,2007,0
1970,2377,0,0,3,1680,290,2008,0
3160,8097,0,0,3,3160,0,2014,0
1210,1200,0,0,3,1210,0,2008,0
3120,5086,0,0,3,2480,640,2008,0
2670,8765,0,0,3,2670,0,2006,0
1640,1204,0,0,3,1640,0,2014,0
2303,3680,0,0,3,2303,0,2013,1923
1800,3168,0,0,3,1800,0,2014,0
4460,2975,0,2,3,3280,1180,2013,1923
1590,2656,0,0,3,1220,370,2009,0
3070,4684,0,0,3,2190,880,2009,0
1330,7200,0,0,3,1330,0,1993,0
990,6750,0,0,4,990,0,1947,1988
1900,5790,0,0,3,1900,0,1994,0
2020,1159,0,3,3,2020,0,2000,0
2000,9416,0,0,4,2000,0,1961,2001
1100,7600,0,0,3,1100,0,1980,0
960,40946,0,0,5,960,0,1945,0
3488,9614,0,0,3,3488,0,1998,2006
1890,9466,0,0,3,1890,0,1987,2000
2030,8120,0,0,3,2030,0,1950,2005
1380,7350,0,0,3,990,390,1981,2013
3660,5800,0,0,3,3360,300,1909,1995
1870,3230,0,0,3,1870,0,1997,0
2080,12007,0,0,4,1220,860,1979,0
2450,14803,0,0,4,2450,0,1988,0
2750,6180,0,0,4,1500,1250,1948,0
1240,4842,0,0,4,1240,0,1916,0
1900,7604,0,0,3,1900,0,1990,2009
2540,6093,0,0,3,2540,0,1999,0
2100,10362,0,0,3,1510,590,1998,2006
1790,2250,0,2,4,840,950,1909,1989
1170,7258,0,0,3,1170,0,1984,0
1060,9126,0,2,5,1060,0,1956,0
1930,6120,0,0,3,1930,0,1941,1969
1540,7947,0,0,3,1120,420,1961,2004
2876,13927,0,2,4,1970,906,1973,0
2150,7484,0,0,3,2150,0,1988,2000
1140,5500,0,0,3,1140,0,1947,2012
980,7790,0,0,5,980,0,1969,0
1230,13056,0,0,4,1230,0,1962,0
1390,10905,0,0,3,860,530,1957,2000
2380,6250,0,3,3,1670,710,1997,0
3690,7200,0,0,3,3690,0,2007,0
3010,1074218,0,0,5,2010,1000,1931,0
1250,9126,0,0,3,1250,0,1969,2010
2290,6120,0,0,4,2170,120,1926,1993
790,5240,0,0,4,790,0,1925,1968
2720,6014,0,0,3,2720,0,2002,0
2550,8632,0,0,3,1700,850,1972,2002
1080,3899,0,0,4,1080,0,1972,0
2470,9620,0,1,4,1570,900,1962,0
850,7710,0,2,5,550,300,1909,1988
1990,8991,0,0,3,1570,420,1969,2010
1800,10500,0,0,3,1800,0,1995,0
4850,36450,0,0,3,4850,0,1977,2004
1020,7874,0,0,3,1020,0,1956,2001
2420,49928,0,0,3,1860,560,1985,0
2910,5776,0,2,3,2910,0,1998,2006
1060,9039,0,0,3,1060,0,1973,2013
2340,6420,0,2,3,1590,750,1964,2000
1800,5453,0,0,3,1050,750,2002,0
1660,6150,0,0,3,850,810,1945,2010
1300,62290,0,0,3,1300,0,1983,2009
1780,23819,0,0,3,1780,0,1953,0
1030,4841,0,0,3,920,110,1939,1969
2790,5420,0,3,3,1130,1660,1963,2013
1150,3000,0,0,5,1150,0,1906,0
3290,11446,0,0,3,3290,0,1992,0
3400,247421,0,0,3,3400,0,2001,0
1200,4000,0,0,3,1070,130,1940,1996
2160,8005,0,0,3,2160,0,1993,0
1450,4000,0,1,4,950,500,1948,0
3240,3600,0,0,3,2060,1180,2008,0
1470,1691,0,0,3,1000,470,2007,0
2360,5226,0,0,3,2360,0,2001,0
2230,9053,0,0,4,2230,0,1987,0
2630,48706,0,0,3,2630,0,1986,0
1010,25000,0,0,3,1010,0,1966,1963
1445,1471,0,0,3,1300,145,2003,0
2380,6000,0,0,3,1320,1060,1935,1974
2830,13059,0,0,3,2830,0,1998,2006
3010,46173,0,0,3,3010,0,1996,0
2000,9000,0,0,4,2000,0,1978,2000
2020,3600,0,0,3,2020,0,1998,2006
2030,6326,0,0,3,2030,0,1993,0
2550,11160,0,0,3,2550,0,1994,0
970,13700,0,0,3,970,0,1949,1998
1540,12446,0,0,5,1540,0,1967,0
1396,111949,0,0,3,1396,0,1940,1997
2780,7875,0,0,3,2780,0,2006,0
2220,8797,0,0,3,2220,0,1977,2004
2350,13402,0,3,3,1670,680,1994,0
2760,40946,0,0,5,2760,0,1978,0
4460,26027,0,0,3,4460,0,1992,0
1440,4421,0,0,3,1440,0,2007,0
5330,6000,0,2,3,3570,1760,2006,0
2220,4228,0,0,3,2220,0,2014,0
5305,8401,0,2,3,3745,1560,2005,0
3880,13095,0,3,3,3700,180,2009,0
3810,8519,0,1,3,2680,1130,2007,0
1960,1168,0,0,3,1600,360,2007,0
1530,1131,0,0,3,1530,0,2009,0
3250,34293,0,0,4,3250,0,1983,0
1750,7208,0,0,3,1750,0,1994,0
3440,35021,0,0,3,3440,0,1983,2009
1170,14149,0,0,5,880,290,1962,0
870,5330,0,0,3,870,0,1969,2014
2930,18199,0,0,3,2930,0,1998,2006
3160,12824,0,2,4,1820,1340,1966,0
800,3330,0,0,3,800,0,1918,0
2350,8001,0,0,4,2350,0,1987,0
1060,16470,0,0,3,1060,0,1977,2004
2060,12558,0,0,4,1350,710,1984,0
1560,1750,0,0,4,780,780,1904,0
3000,42200,0,3,3,1500,1500,1950,2005
1660,4800,0,0,3,1660,0,1907,1983
1650,5100,0,0,5,1040,610,1908,0
3220,8936,0,0,3,2450,770,1990,2009
2320,7500,0,0,3,2320,0,1976,0
2750,14982,0,3,3,1720,1030,1981,2013
910,6000,0,0,2,910,0,1956,0
840,867,0,0,3,840,0,2005,0
1470,1578,0,0,3,1090,380,2007,0
2040,10812,0,0,4,2040,0,1943,0
1100,4046,0,4,4,1100,0,1922,0
940,8532,0,0,4,940,0,1959,0
1110,10500,0,0,5,1110,0,1978,0
2200,8100,0,0,5,1400,800,1942,0
2860,59612,1,4,3,1510,1350,1948,2003
740,11250,0,0,2,740,0,1938,0
2740,8520,0,2,3,1370,1370,1954,2005
1250,7300,0,0,4,1250,0,1956,0
3140,8060,0,0,3,3140,0,1991,0
820,10270,0,0,3,820,0,1954,2005
2570,7264,0,0,3,1720,850,1998,2006
2350,8140,0,0,4,1430,920,1977,0
3600,9200,0,4,4,2100,1500,1976,1992
1580,8000,0,0,3,1040,540,1967,2011
1070,5824,0,2,5,1070,0,1949,0
1070,6109,0,0,5,1070,0,1951,0
1640,5000,0,0,3,1640,0,1907,1983
2890,12130,0,3,4,2830,60,1987,0
1220,7876,0,0,3,1220,0,1966,1963
1400,4500,0,0,3,900,500,1922,2008
1040,6250,0,0,3,1040,0,1942,1999
980,10640,0,0,5,980,0,1978,0
3340,10890,0,0,3,2240,1100,1963,2000
6040,219542,0,0,3,4100,1940,1996,0
1900,1612,0,0,3,1430,470,2008,0
1740,7292,0,0,3,1020,720,1962,2003
2000,3207,0,0,4,1100,900,1916,0
1610,7200,0,0,3,1090,520,1973,2013
3240,13978,0,0,3,1860,1380,1977,2004
2230,9600,0,0,3,1320,910,1978,0
1160,2174,0,0,3,1160,0,1998,2006
2410,6000,0,0,5,1410,1000,1950,0
590,10945,0,0,3,590,0,1983,2009
2600,17388,0,0,3,2600,0,1996,0
2170,8240,0,0,4,1370,800,1968,0
2080,4000,0,0,3,2080,0,1912,2000
2860,12394,0,0,3,2860,0,1999,0
2980,8107,0,0,3,2980,0,2000,0
1230,987,0,0,3,1060,170,2011,0
2260,7005,0,1,4,1130,1130,1947,1988
2200,14925,0,0,3,1100,1100,1982,0
3030,12590,0,0,4,3030,0,1988,0
1060,1600,0,0,3,1060,0,1979,2014
4260,18687,0,0,3,4260,0,1996,0
998,844,0,0,3,798,200,2007,0
2052,3723,0,0,3,2052,0,2014,0
3150,6202,0,0,3,3150,0,2005,0
1950,7221,0,0,4,1950,0,2006,0
1347,1292,0,0,3,1347,0,2010,0
3860,5474,0,0,3,3860,0,2007,0
5060,10320,0,0,3,5060,0,2008,0
1360,885,0,0,3,1360,0,2008,0
2760,6000,0,0,3,2760,0,2006,0
2420,4670,0,0,3,2420,0,2013,1923
2450,4332,0,0,3,2450,0,2010,0
1280,959,0,0,3,1280,0,2005,0
1550,3569,0,0,3,1550,0,2011,0
550,1279,0,0,3,550,0,2008,0
1520,1588,0,0,3,1240,280,2007,0
1670,4005,0,0,4,1170,500,1939,1989
430,5050,0,0,2,430,0,1912,0
2380,9614,0,0,4,2380,0,1991,0
960,9633,0,0,5,960,0,1982,0
1920,6862,0,2,3,1120,800,1952,2008
3680,5854,0,3,3,2060,1620,1967,2011
2530,9200,0,0,5,1570,960,1976,0
3840,16905,0,0,3,3840,0,1991,0
1240,3600,0,0,5,1240,0,1926,0
1300,11867,0,0,4,1300,0,1975,0
2380,12067,0,0,3,2380,0,2002,0
1300,44431,0,0,5,1300,0,1958,0
780,13500,0,0,4,780,0,1946,1989
1810,39639,0,0,3,1230,580,1970,2014
2420,12676,0,0,3,2420,0,1911,1986
1280,2580,0,0,3,1280,0,1910,2014
1680,6500,0,0,4,1140,540,1941,1998
2510,5400,0,0,3,2510,0,1992,0
1700,8645,0,0,3,1700,0,1955,2005
1680,3420,0,0,3,960,720,1992,0
820,59677,0,0,3,820,0,1999,0
4380,42769,0,0,5,4380,0,1983,0
2600,10092,0,0,3,2600,0,1984,0
3400,7452,0,0,3,3400,0,1999,0
2120,8399,0,0,4,1320,800,1942,1982
2250,5700,0,0,3,1200,1050,1951,1994
1800,5612,0,0,4,1200,600,1942,1982
2210,7620,0,0,3,2210,0,1994,0
1560,4080,0,0,3,1560,0,1923,1982
2430,20720,0,0,3,2430,0,1967,2011
2560,36601,0,0,4,2560,0,1987,0
1960,2500,0,0,5,1410,550,1926,0
1110,9762,0,0,4,1110,0,1963,0
1030,4500,0,0,3,830,200,1924,2011
1350,11507,0,0,3,1350,0,1966,1963
1540,1827,0,0,3,1540,0,2005,0
1830,9600,0,0,4,1010,820,1966,0
1930,15531,0,0,3,1930,0,1979,2014
1650,9641,0,0,3,1650,0,1983,2009
3510,12905,0,2,3,2210,1300,1965,1982
3370,7920,0,3,3,1860,1510,1988,2000
2390,9157,0,0,3,2390,0,1984,0
1230,8114,0,0,4,1230,0,1951,1999
2830,213879,0,0,4,2830,0,1987,0
1620,7540,0,0,3,1310,310,1988,2000
2290,6250,0,0,5,1690,600,1940,0
2840,13367,0,0,3,1420,1420,1952,2008
4220,196817,0,0,3,4220,0,1993,0
1080,10500,0,0,3,1080,0,1967,2011
1620,8645,0,0,3,1190,430,1973,2013
4390,11600,0,3,3,3060,1330,1990,2009
1620,3975,0,0,5,940,680,1926,0
1010,11244,0,0,4,1010,0,1947,1988
1750,8476,0,0,4,1240,510,1983,0
4080,217697,0,3,3,4080,0,2000,0
2560,10400,0,0,4,1280,1280,1965,0
1120,5500,0,0,4,1120,0,1925,1968
4740,172497,0,0,3,4740,0,2003,0
1340,7788,0,2,3,1340,0,1947,2012
1590,6750,0,0,3,1590,0,1951,1994
1430,5000,0,0,4,1080,350,1919,1985
1450,8960,0,0,3,1450,0,1943,2002
3500,7200,0,0,3,3500,0,2005,0
1630,8702,0,0,3,1630,0,1987,2000
1814,5000,0,0,4,944,870,1951,1999
580,7500,0,0,3,580,0,1943,2002
1670,4572,0,0,3,1670,0,1931,0
1140,8282,0,0,3,1140,0,1924,2009
800,6380,0,2,3,800,0,1940,1996
1300,2580,0,0,5,820,480,1919,1934
2440,7155,0,0,3,2440,0,1993,0
1490,8371,0,0,3,1490,0,1984,0
1800,9550,0,0,4,1320,480,1966,0
1830,9152,0,0,5,1830,0,1959,0
1500,3920,0,0,3,1000,500,1947,2012
2210,6080,0,2,4,1410,800,1965,0
1270,1323,0,0,3,1270,0,2006,0
1140,1730,0,0,3,1010,130,2007,0
1620,1173,0,4,3,1470,150,2008,0
1220,1186,0,0,3,1220,0,2007,0
750,1430,0,0,3,750,0,2006,0
1960,9300,0,0,5,1340,620,1979,0
1370,3000,0,0,3,1370,0,1924,2011
4580,4443,1,4,3,4580,0,2004,2003
5584,68257,0,0,3,5584,0,1998,2006
1010,4320,0,0,5,1010,0,1924,1956
1260,6908,0,0,3,1260,0,1994,0
1740,5782,0,0,4,1740,0,1989,0
2670,10026,0,0,3,2670,0,1996,0
720,7200,0,0,5,720,0,1943,0
2460,4399,0,0,3,2460,0,2007,0
3670,7000,0,0,3,3670,0,2005,0
2630,3435,0,3,3,1640,990,1984,0
1570,8459,0,0,3,1570,0,1991,0
2980,28000,0,0,3,1820,1160,1981,2013
1560,4200,0,0,3,1560,0,2003,0
1620,7410,0,0,5,1620,0,1955,0
1140,5000,0,0,3,1140,0,1960,2012
2730,19877,0,0,4,1570,1160,1976,1992
2130,35169,0,0,4,2130,0,1989,0
1780,4050,0,0,3,1780,0,2001,0
2100,3916,0,0,3,2100,0,2009,0
1140,8800,0,0,3,1140,0,1972,2002
1690,9144,0,0,4,1140,550,1956,0
1160,6000,0,0,4,860,300,1942,1982
1720,6270,0,0,3,1720,0,1978,0
1210,3328,0,0,4,1210,0,1924,0
1255,1374,0,0,3,1255,0,2004,2003
880,7683,0,0,3,880,0,1942,1999
1050,9206,0,0,3,1050,0,1954,2005
1650,12940,0,0,4,1650,0,1961,2001
1570,9467,0,0,3,1570,0,1954,2005
2920,7200,0,3,3,1470,1450,1921,2006
3000,4000,0,3,3,1970,1030,1913,2014
1850,7735,0,0,4,1850,0,1983,0
1440,7741,0,0,4,1000,440,1983,0
1440,8775,0,0,3,1440,0,1973,2013
1810,12375,0,0,3,1810,0,1970,2014
1180,9350,0,0,3,1180,0,1918,0
3070,5850,0,0,5,2400,670,1927,0
3390,5211,0,0,3,3390,0,2004,2003
1470,6120,0,0,2,1470,0,1940,0
2680,7200,0,0,3,1380,1300,1952,2013
2290,10687,0,0,3,2290,0,1978,0
1980,8100,0,0,4,1310,670,1949,1985
2870,9292,0,0,3,2540,330,1979,2014
1840,4750,0,0,5,1010,830,1951,0
4060,13000,0,3,3,4060,0,2000,0
1630,8018,0,0,3,1630,0,2003,0
1880,5400,0,0,3,1880,0,1902,0
1780,13095,0,0,4,1780,0,1983,0
2330,6250,0,0,4,1400,930,1941,1998
1840,4030,0,0,5,1050,790,1925,0
2330,10750,0,0,4,1190,1140,1962,0
3200,6473,0,0,3,3200,0,2005,0
2330,1987,0,4,3,1410,920,2004,2003
1950,8868,0,0,3,1350,600,1964,2000
3080,4815,0,3,3,2300,780,1937,2009
1040,5527,0,0,3,1040,0,1951,1994
1960,3565,0,0,3,1960,0,1940,2003
2750,3800,0,0,5,1750,1000,1926,0
1930,36210,0,0,3,1930,0,1977,2004
4850,40902,0,0,3,4850,0,2001,0
1982,6406,0,0,3,1982,0,2004,2003
2640,4050,0,0,5,1750,890,1926,0
1850,50662,0,0,3,1430,420,1978,0
1940,9144,0,0,4,1430,510,1956,0
2840,7199,0,0,3,1710,1130,2003,0
1900,10226,0,0,3,1130,770,1961,2004
1410,6400,0,0,5,960,450,1955,0
2520,8515,0,0,3,2520,0,1999,0
3160,9525,0,0,3,3160,0,1997,0
3720,29043,0,0,3,3720,0,1991,0
1820,1501,0,0,3,1430,390,2014,0
1560,8640,0,0,5,1560,0,1967,0
1600,5952,0,0,4,1150,450,1964,0
1230,11502,0,0,4,1230,0,1984,0
960,8100,0,0,3,960,0,1955,2005
1270,4000,0,2,3,1270,0,1928,1954
2810,7700,0,0,3,2810,0,2001,0
2160,5581,0,0,3,2160,0,2002,0
2520,2152,0,0,3,1560,960,1925,2006
1180,844,0,0,3,990,190,2005,0
1810,4970,0,0,3,1810,0,2003,0
1680,15711,0,0,3,1240,440,1994,0
910,5250,0,0,4,910,0,1971,0
3250,5797,0,2,4,2370,880,1951,1999
2000,7294,0,0,3,1520,480,1965,1993
3790,19000,0,4,3,3790,0,1985,0
2310,78844,0,0,3,1760,550,1977,2004
2510,6339,0,2,5,1810,700,1932,2002
1320,6205,0,0,5,1320,0,1948,1985
2370,217800,0,0,3,2370,0,1979,2014
900,7500,0,0,4,900,0,1972,0
2540,7680,0,1,4,2540,0,1940,2001
2100,9288,0,0,4,1050,1050,1968,0
1200,6250,0,0,3,920,280,1943,2002
3720,15200,0,0,3,3720,0,2005,0
1760,4539,0,0,3,1760,0,1988,2000
1670,7415,0,0,3,1320,350,1987,2000
2420,8252,0,0,3,2420,0,1998,2006
3480,15185,0,0,4,3480,0,1964,0
1630,4473,0,0,3,1630,0,2003,0
2340,5600,0,0,3,2340,0,1921,2013
920,3780,0,0,3,920,0,1910,2006
910,6490,0,0,3,910,0,1942,1999
1150,4945,0,2,3,1150,0,1943,2002
2500,4774,0,2,3,1450,1050,1940,1996
3250,235063,0,2,3,3250,0,1973,2013
1930,6600,0,0,4,1030,900,1967,0
3400,234352,0,0,3,2500,900,1991,0
1590,2550,0,0,3,1590,0,1985,0
3330,7399,0,0,3,3330,0,2009,0
4590,14685,0,0,3,4590,0,2009,0
2610,7256,0,0,3,2610,0,2014,0
1658,2700,0,0,3,1658,0,2014,0
1600,1431,0,0,3,1240,360,2006,0
1296,1051,0,0,3,1296,0,2009,0
1280,835,0,0,3,1080,200,2009,0
5940,11533,0,4,3,4950,990,2004,2003
2510,5311,0,0,3,2510,0,2009,0
2710,3475,0,0,3,1650,1060,2005,0
1750,1548,0,0,3,1750,0,2013,1923
1430,19901,0,0,4,1430,0,1927,0
1660,34848,0,0,1,930,730,1933,0
1320,8865,0,0,4,1320,0,1943,0
2580,209523,0,0,3,2580,0,1984,0
2740,43101,0,0,3,2740,0,1993,0
2495,4400,0,0,3,2495,0,2007,0
2300,24773,0,0,4,2300,0,1950,1985
1300,12240,0,0,3,1300,0,1963,2008
2230,10414,0,0,5,1450,780,1974,0
2020,2750,0,0,3,1010,1010,1917,2014
2000,3800,0,0,3,2000,0,2001,0
1060,8187,0,0,4,1060,0,1952,0
2080,4800,0,0,5,1080,1000,1923,0
2030,24829,0,0,4,1220,810,1979,0
2690,7000,0,0,5,1840,850,1943,0
3240,10800,0,0,3,2260,980,1946,0
1550,12920,0,0,5,1550,0,1999,0
1480,3132,0,0,5,740,740,1910,0
3040,2800,0,0,3,2100,940,1906,2014
1560,7300,0,0,4,1040,520,1964,0
2250,3757,0,0,3,2250,0,2006,0
1100,4600,0,0,3,1100,0,1917,2009
1700,6356,0,0,3,1700,0,1907,1983
2680,28014,0,0,4,1450,1230,1963,0
800,2296,0,0,4,800,0,1908,0
1350,6315,0,0,3,1350,0,2005,0
820,7680,0,0,3,820,0,1910,2006
3160,4270,0,0,3,2650,510,2006,0
1720,28000,0,0,4,1720,0,1958,1972
1680,6755,0,0,3,1680,0,1994,0
1300,7958,0,0,3,1300,0,1996,0
2190,10370,0,0,3,2190,0,1987,2000
1720,4006,0,0,3,1720,0,1994,0
1160,11776,0,0,3,1160,0,1968,1997
3150,34830,0,0,3,3150,0,1957,2005
1210,8075,0,0,4,1210,0,1983,0
1980,5100,0,0,3,1270,710,1965,1993
2990,5669,0,0,3,2990,0,2003,0
1430,9600,0,0,4,1430,0,1966,0
2060,4030,0,0,3,2060,0,1999,0
2230,52983,0,0,3,2230,0,1991,0
3090,18645,0,0,3,3090,0,1995,0
4250,23326,0,3,3,2150,2100,1967,2011
1970,23180,1,4,3,1100,870,1937,1998
1700,3171,0,0,5,850,850,1927,0
2510,5503,0,2,3,2510,0,1995,0
3610,17580,0,4,5,2070,1540,1959,0
2980,7000,0,3,3,2140,840,1900,2014
1610,6480,0,0,4,1610,0,1947,1988
3650,6982,0,2,4,2530,1120,1951,2003
2510,38141,0,0,3,2510,0,1960,2012
1110,6000,0,0,5,1110,0,1932,2002
1650,6150,0,0,4,1650,0,1926,1993
1980,12150,0,0,3,1980,0,1994,0
880,1157,0,0,3,880,0,2007,0
1490,9800,0,0,4,1140,350,1947,1988
2520,5400,0,0,4,1410,1110,1906,1990
1820,22320,0,0,3,1250,570,1977,2004
4140,9066,0,0,3,2070,2070,1978,0
3420,8405,0,0,3,3420,0,2000,0
3150,7277,0,0,3,3150,0,2006,0
1580,7416,0,0,3,1150,430,1967,2011
1660,8281,0,0,3,1660,0,1949,1998
1100,10125,0,0,3,1100,0,1969,2010
1270,3200,0,0,4,960,310,1920,0
1450,6250,0,0,3,990,460,1964,2000
1830,9485,0,0,4,1200,630,1989,0
1300,4127,0,0,4,650,650,1918,1953
2320,5500,0,2,3,1720,600,1925,2000
1680,9545,0,0,4,1080,600,1979,0
2300,5500,0,0,4,2000,300,1921,0
1400,4000,0,0,3,870,530,1951,1994
2410,4560,0,2,5,1800,610,1929,0
1480,7480,0,0,4,1480,0,1992,0
1390,9624,0,0,4,1390,0,1954,1979
830,2699,0,0,3,830,0,1996,0
740,9003,0,0,3,740,0,1949,1998
1940,6000,0,0,5,970,970,1945,0
1340,15600,0,0,4,1340,0,1978,2000
4440,6480,0,3,5,3140,1300,1959,0
800,6240,0,0,3,800,0,1954,2005
1310,9645,0,0,3,1310,0,1979,2014
2330,4000,0,0,5,1300,1030,1924,1956
1400,1243,0,0,3,1400,0,2000,0
2360,4367,0,0,3,2360,0,2003,0
1840,5752,0,0,3,1840,0,2003,0
2680,7178,0,0,3,2680,0,2004,2003
3890,7140,0,2,3,2390,1500,1943,2007
1400,8640,0,0,5,1400,0,1968,0
2400,9701,0,0,3,2400,0,1990,2009
2920,46355,0,0,4,2920,0,1998,0
1390,1302,0,0,3,1390,0,1986,0
1680,11193,0,0,3,1680,0,1984,0
2040,8800,0,0,4,1020,1020,1961,2001
1080,4000,0,0,3,1080,0,1940,1996
2280,4280,0,0,5,1280,1000,1917,0
4490,5099,0,0,3,3390,1100,2006,0
4700,9160,0,4,3,2520,2180,2005,0
2798,4473,0,0,3,2798,0,2012,1912
2810,5400,0,0,3,2810,0,2005,0
3753,7204,0,0,3,3336,417,2008,0
3910,8095,0,0,3,3130,780,2007,0
1050,1609,0,0,3,1050,0,2005,0
1600,4300,0,0,4,1600,0,1916,0
2590,10002,0,0,4,1340,1250,1968,0
1720,9753,0,0,4,1120,600,1978,2000
4410,14034,0,2,4,2350,2060,1965,0
1590,11914,0,2,3,1090,500,1957,2000
2440,22594,0,0,3,2440,0,1996,0
1360,1016,0,0,3,1310,50,2003,0
910,7000,0,0,3,910,0,1952,2008
1390,7200,0,0,3,1140,250,1965,1993
1470,14821,0,0,4,1470,0,1958,1972
2920,9904,0,0,4,2920,0,1990,0
1950,52256,0,0,4,1950,0,1985,0
2390,4555,0,0,3,2390,0,2006,0
1270,11600,0,0,4,1270,0,1964,0
950,7560,0,0,3,950,0,1958,2004
900,423838,0,2,5,900,0,1925,0
2280,6660,0,2,3,1960,320,1940,1984
1010,5490,0,0,3,1010,0,1954,2005
1260,5000,0,0,3,1040,220,1951,1994
4730,13586,0,0,5,4270,460,1935,0
2620,21587,0,0,3,2620,0,1992,0
2330,4000,0,2,5,1520,810,1927,0
2170,2440,0,0,4,1450,720,1911,1966
2450,9488,0,0,4,1240,1210,1900,1955
1880,7632,0,0,4,1180,700,1978,2000
2300,3400,0,0,5,1550,750,1915,0
1240,14404,0,0,3,1240,0,1988,2000
820,3844,0,0,4,820,0,1916,0
1530,6375,0,0,3,1530,0,1942,1983
2900,12160,0,0,4,1890,1010,1967,0
1240,3867,0,0,3,800,440,1987,2000
4140,13392,0,0,3,4140,0,2000,0
2240,7725,0,0,5,1120,1120,1956,0
1480,5000,0,0,4,750,730,1928,0
2270,8876,0,0,3,1380,890,1977,2004
1250,6250,0,0,2,1030,220,1949,0
1930,9747,0,0,4,1020,910,1962,0
1700,7800,0,0,5,1120,580,1981,0
1590,6420,0,0,3,1590,0,1944,0
1880,10000,0,0,3,960,920,1963,2008
1640,4240,0,0,5,920,720,1921,0
2600,5085,0,0,4,1400,1200,1940,2001
710,1173,0,0,4,710,0,1943,0
6980,15682,0,4,4,5330,1650,1999,0
1460,5040,0,0,3,1100,360,1971,0
2080,9827,0,0,3,2080,0,1989,0
2630,9216,0,0,3,2630,0,2003,0
4430,21000,0,0,3,4430,0,1952,2007
2760,6850,0,0,3,2760,0,1999,0
1670,12056,0,0,3,1670,0,1955,2005
1990,4725,0,0,4,1190,800,1944,0
2600,5238,0,3,3,1890,710,1989,0
1320,1824,0,0,4,1320,0,1909,1989
2240,3800,0,0,3,1370,870,1929,0
1960,8680,0,0,4,1290,670,1959,0
2590,108900,0,0,3,1980,610,1988,2000
2620,6707,0,0,3,2620,0,2000,0
2770,9136,0,0,3,2770,0,1991,0
2110,10005,0,0,5,1110,1000,1924,1956
2290,4539,0,0,3,2290,0,2001,0
4960,6000,0,0,3,3680,1280,1909,2003
1110,26051,0,0,3,1110,0,1951,1994
3310,6166,0,0,3,3310,0,2008,0
900,8580,0,0,3,900,0,1918,0
1940,7313,0,1,4,1440,500,1960,2001
1590,7617,0,0,3,1590,0,1986,0
2930,6050,0,0,3,2930,0,2008,0
2040,22653,0,0,3,2040,0,2011,0
1000,905,0,0,3,1000,0,2006,0
1730,1229,0,2,3,1320,410,2008,0
1220,4800,0,0,3,1220,0,1901,0
3060,12095,0,0,3,3060,0,1983,2009
2910,5000,0,0,3,2910,0,2002,0
1050,5850,0,0,3,1050,0,1980,0
1560,7352,0,0,3,1560,0,1992,0
1680,3000,0,2,4,840,840,1900,1971
4140,20734,0,1,3,3300,840,1977,2005
1550,8509,0,0,3,1150,400,1959,1989
5700,20000,0,4,4,2850,2850,1977,0
2200,7278,0,0,3,2200,0,1990,2009
1740,2500,0,2,3,1210,530,1994,0
1210,9525,0,0,3,1210,0,1955,2005
4240,25639,0,3,3,3550,690,1989,0
1590,11745,0,0,3,1090,500,1978,0
3420,7200,0,3,5,1770,1650,1947,0
3190,11375,0,0,5,2210,980,1946,0
1920,5405,0,2,4,960,960,1947,1988
1340,4664,0,0,3,1340,0,2004,2003
1700,8400,0,0,3,1460,240,1947,2012
2310,3570,0,0,3,1490,820,1927,2014
1510,44000,0,0,3,1240,270,1989,0
2670,10082,0,0,3,2670,0,1987,2000
2060,8470,0,0,3,1440,620,1983,2009
2090,6000,0,0,4,2090,0,1928,0
3090,23265,0,0,3,2990,100,1957,2000
1240,1546,0,0,3,1240,0,2007,0
1860,3690,0,0,3,1860,0,2000,0
2000,7350,0,0,3,2000,0,1953,0
2500,92347,0,0,4,1500,1000,1970,0
1820,20349,0,0,5,1340,480,1977,0
1820,8058,0,0,3,1260,560,1974,0
1060,5750,0,0,3,1060,0,1981,2013
1950,9906,0,0,3,1950,0,1988,2000
940,4800,0,0,4,940,0,1911,1955
1220,3568,0,0,4,1220,0,1976,1992
4180,17935,0,0,3,4180,0,2004,2003
1200,9800,0,0,4,1200,0,1971,0
3990,18897,0,0,3,3090,900,1937,2010
1880,7560,0,0,3,940,940,1919,2001
2280,7200,0,0,3,2280,0,1994,0
2580,11000,0,0,4,1290,1290,1951,1999
2600,4674,0,0,3,1560,1040,1976,0
3150,13700,0,0,4,3150,0,1966,0
5550,28078,0,2,4,3350,2200,2000,0
2220,4000,0,0,3,1230,990,1973,2013
1730,31491,1,2,4,1730,0,1947,1988
2840,4120,0,0,4,2060,780,1931,0
2560,8780,0,0,3,2560,0,1992,0
1330,6000,0,0,4,630,700,1900,1971
1890,5202,0,0,4,1890,0,1909,1989
4290,37607,0,0,5,4290,0,1982,0
1540,54450,0,0,3,1540,0,1983,2009
2340,50233,0,0,4,1170,1170,1966,0
2180,10230,0,0,4,1090,1090,1961,2001
2780,11964,0,0,3,2780,0,2009,0
2620,6019,0,0,3,2620,0,2013,1923
3760,5000,0,0,3,2860,900,2014,0
2720,4738,0,0,3,2720,0,2012,1912
2675,40910,0,0,3,2675,0,1984,0
2080,13189,0,0,3,2080,0,1987,2000
2460,12028,0,0,3,2460,0,1996,0
1960,3480,0,0,3,1960,0,2004,2003
2550,6256,0,0,3,2550,0,1992,0
1760,1146,0,0,3,1760,0,2014,0
1620,7330,0,0,4,1090,530,1974,0
1790,12000,0,0,3,1040,750,1960,2012
3480,7232,0,0,3,2580,900,1926,2010
2780,9900,0,0,4,2780,0,1978,2000
3640,8239,0,3,3,2540,1100,1982,0
750,4000,0,0,3,750,0,1918,0
960,6634,0,0,3,960,0,1952,2008
2030,8880,0,0,3,1330,700,1963,2008
2930,5569,0,0,3,1860,1070,2004,2003
1380,1073,0,0,3,1140,240,2011,0
1720,5525,0,2,5,960,760,1941,0
1210,4800,0,0,3,1060,150,1950,2005
950,4250,0,0,5,950,0,1948,1985
1710,4234,0,0,3,1330,380,1920,1979
1410,12282,0,0,5,1410,0,1909,1988
2910,7631,0,2,3,2910,0,2006,0
2220,7064,0,0,3,2220,0,1988,2000
3160,13238,0,0,5,3160,0,1972,0
1380,4500,0,0,3,1380,0,2008,0
1760,5000,0,0,5,960,800,1920,0
730,3000,0,0,3,730,0,1911,1979
2460,5000,0,0,5,1620,840,1938,0
2160,6272,0,0,4,1390,770,1960,2001
1990,4600,0,2,4,1420,570,1932,1958
3740,39640,0,2,3,3740,0,1991,0
2710,5500,0,0,3,2710,0,1999,0
2680,7836,0,0,3,2680,0,1990,2009
1850,7560,0,0,4,1540,310,1978,2000
3190,7869,0,2,3,3190,0,2001,0
2730,5832,0,0,3,2730,0,1998,2006
1840,9990,0,0,5,1840,0,1961,0
2720,10000,0,0,3,2720,0,1987,2000
4370,8510,0,1,3,3610,760,2003,0
2290,3475,0,0,3,2290,0,2006,0
990,4802,0,0,3,990,0,1947,2012
1140,2980,0,0,3,1140,0,1988,2000
1840,4337,0,0,4,1840,0,1917,0
1110,6800,0,0,5,1000,110,1947,0
2150,9070,0,0,4,2150,0,1985,0
2230,5750,0,0,3,2230,0,2003,0
1170,6000,0,0,4,970,200,1941,1998
1960,7200,0,0,4,980,980,1940,2001
2610,9002,0,0,3,2610,0,1988,2000
2130,8721,0,0,3,1570,560,1987,2000
3020,43560,0,0,3,2720,300,1969,2010
1670,5400,0,0,5,1670,0,1912,0
1890,7004,0,0,3,1290,600,1965,1993
950,13475,0,0,3,950,0,1950,2005
2430,14400,0,0,5,1670,760,1963,0
2360,6000,0,0,5,1260,1100,1939,0
1510,8301,0,0,3,1510,0,1967,2011
2080,4828,0,0,3,2080,0,2002,0
1750,15500,0,0,3,1490,260,1982,0
1810,4064,0,0,3,1810,0,1925,2002
1790,11875,0,0,4,1490,300,1969,0
2340,11034,0,0,3,1720,620,1967,2011
1690,9626,0,0,3,1690,0,1984,0
2070,7476,0,0,3,2070,0,2003,0
2240,6396,0,0,3,2240,0,2002,0
4500,21780,0,2,3,3040,1460,1980,0
2770,39927,0,0,4,1580,1190,1978,2000
1010,7245,0,0,3,1010,0,1969,2010
1120,6900,0,0,5,1120,0,1956,0
3020,21441,0,0,4,1510,1510,1978,2000
4400,186846,0,0,4,4400,0,1993,0
1990,5650,0,1,3,1320,670,1963,2008
1450,8820,0,0,3,1050,400,1958,2004
1920,8497,0,0,3,1920,0,1998,2006
1175,1366,0,0,3,740,435,2005,0
1320,13200,0,0,3,1320,0,1970,2014
3990,3839,0,0,4,1990,2000,1962,0
1140,5720,0,0,3,850,290,1947,2012
1720,4240,0,0,4,1460,260,1925,1968
2150,9915,0,0,5,1240,910,1976,0
1790,8203,0,1,3,1790,0,1910,2006
2210,6327,0,0,3,2210,0,2003,0
2180,7519,0,0,4,1310,870,1981,0
1410,1290,0,0,3,1290,120,2004,2003
1950,3600,0,0,3,1950,0,2010,0
1495,936,0,0,3,1405,90,2006,0
1660,6000,0,0,3,1110,550,1979,2014
1950,8130,0,0,4,1950,0,1990,0
2550,5040,0,0,5,2550,0,1902,0
1370,3850,0,0,5,770,600,1911,1988
2200,4000,0,0,5,1430,770,1908,0
1250,6041,0,0,5,1250,0,1942,0
2220,8872,0,0,4,1110,1110,1961,2001
1620,4200,0,0,5,830,790,1945,0
2250,26337,0,0,3,2250,0,1980,0
1720,99916,0,0,4,1720,0,1990,0
3030,9687,0,0,3,2020,1010,1998,2006
1030,9120,0,0,3,1030,0,1961,2004
2190,4882,0,0,3,2190,0,1999,0
1440,5600,0,0,4,720,720,1942,2007
2170,9600,0,0,3,1460,710,1980,0
2930,3200,0,0,5,2130,800,1925,0
1180,9048,0,0,3,1180,0,1960,2012
2360,57514,0,0,4,2360,0,1939,1987
1660,8797,0,0,4,1660,0,1956,0
2390,9313,0,0,5,1390,1000,1942,0
1360,5120,0,0,4,910,450,1924,0
1840,3500,0,0,5,1540,300,1910,0
1800,43647,0,0,4,1800,0,1976,1992
4130,12320,0,0,3,4130,0,2001,0
2220,132858,0,0,3,1110,1110,1988,2000
3490,9680,0,4,3,2460,1030,1980,0
1830,5175,0,0,3,1830,0,2003,0
1550,4000,0,0,3,1550,0,1930,1997
2050,9000,0,0,4,2050,0,1951,1999
1230,6600,0,0,3,1130,100,1906,2014
3150,5886,0,0,3,3150,0,2014,0
3800,33825,0,0,4,3330,470,1976,1992
1350,3068,0,0,3,1350,0,1991,0
1530,8700,0,0,4,1530,0,1970,0
2290,2798,0,0,4,2290,0,1953,1983
1480,15641,0,0,4,1480,0,1940,2001
1970,10270,0,0,4,1970,0,1966,0
720,4840,0,0,4,720,0,1947,1988
1080,7236,0,0,5,1080,0,1947,0
2790,45902,0,0,3,2790,0,1987,2000
2040,7488,0,0,4,1200,840,1969,0
1320,8220,0,0,3,1320,0,1959,1989
1680,57063,0,0,4,1680,0,1989,0
2140,4923,0,0,4,1070,1070,1928,0
1660,9600,0,0,3,1380,280,1981,2013
1540,5338,0,0,5,770,770,1954,0
1880,10758,0,0,5,940,940,1952,1998
1250,15603,0,0,4,1250,0,1959,0
2120,137565,0,0,3,2120,0,1913,1983
1810,3000,0,0,4,1810,0,1903,0
2370,11172,0,0,3,2370,0,1993,0
1970,4036,0,0,4,1970,0,2003,0
2110,4099,0,0,3,2110,0,2001,0
2080,10521,0,0,3,2080,0,2004,2003
3720,12384,0,2,5,1860,1860,1970,0
1370,5125,0,0,5,1370,0,1944,0
2961,12146,0,0,3,2961,0,1998,2006
2090,12112,0,0,3,2090,0,1983,2009
2600,7210,0,0,3,2600,0,1989,0
1870,9000,0,0,3,1440,430,1978,0
2620,9873,0,0,3,2620,0,1987,2000
2430,54059,0,0,3,2430,0,1987,2000
1340,16480,0,0,4,1340,0,1968,0
1170,10621,0,0,3,1170,0,1963,2008
2000,10182,0,0,5,1400,600,1963,0
2070,12000,0,0,4,1340,730,1967,0
4590,9150,0,0,3,3490,1100,1981,2013
2550,4623,0,0,4,2550,0,1905,0
1060,9600,0,0,4,1060,0,1962,0
1220,5000,0,0,5,860,360,1921,0
1790,7203,0,0,4,1110,680,1973,0
2060,4040,0,0,4,1120,940,1947,1988
1140,1182,0,0,3,1140,0,2007,0
2870,12648,0,0,4,2870,0,1986,0
2550,33740,0,0,4,1750,800,1958,1972
2790,10125,0,0,5,2790,0,1985,0
1110,7962,0,0,3,1110,0,1962,2003
940,5375,0,0,4,940,0,1952,0
2880,18296,0,0,3,1580,1300,1958,2004
1200,4800,0,0,4,1200,0,1962,0
1030,4958,0,0,5,1030,0,1952,1998
1240,2689,0,0,3,1240,0,1986,0
1200,9566,0,0,3,1200,0,1995,0
2780,4002,0,0,3,2780,0,2009,0
1765,7652,0,0,3,1765,0,1996,0
1960,14242,0,1,4,1290,670,1958,1972
2680,11214,0,0,3,2680,0,2006,0
1410,7622,0,0,4,1410,0,1983,0
2240,3712,0,0,3,2240,0,2014,0
3120,7644,0,0,3,3120,0,2010,0
1450,4706,0,0,3,1450,0,2009,0
2340,5002,0,0,3,2340,0,2013,1923
2481,4045,0,0,3,2481,0,2014,0
1530,1602,0,0,3,1140,390,2013,1923
1250,7500,0,0,5,1250,0,1942,0
560,12120,0,0,3,560,0,1967,2011
2200,7475,0,0,5,1100,1100,1955,0
1460,10584,0,0,3,990,470,1997,0
1650,9380,0,0,5,1130,520,1978,0
3200,17204,0,0,3,2160,1040,1952,2008
2560,41346,0,0,3,2560,0,1986,0
2080,4252,0,0,3,1550,530,2003,0
1070,7140,0,0,3,1070,0,1989,0
2190,12626,0,0,4,2190,0,1978,2000
2060,15837,0,0,3,2060,0,1903,2005
2640,8000,0,3,4,1320,1320,1960,2001
1720,8755,0,0,3,1000,720,1983,2009
3880,13885,0,3,4,2540,1340,1979,0
960,4920,0,0,3,960,0,1942,1999
2340,59058,0,0,3,2340,0,1985,0
2660,13367,0,2,3,2660,0,1992,0
2090,4725,0,0,3,1610,480,1947,2013
1820,4910,0,0,3,1820,0,1993,0
2310,8030,0,0,3,2310,0,1978,0
920,14400,0,0,4,920,0,1977,0
790,13062,0,0,3,790,0,1942,1999
1500,6800,0,0,4,910,590,1942,1982
1240,11108,0,0,4,1240,0,1952,0
2730,36183,0,0,3,2730,0,1986,0
1170,11000,0,0,2,1170,0,1980,0
3410,9088,0,3,3,2760,650,1912,1994
2700,9320,0,0,4,2700,0,1994,0
1650,7800,0,0,3,1650,0,1968,1997
670,2378,0,0,3,670,0,1919,2001
1670,7757,0,0,3,1670,0,1992,0
1530,10731,0,0,3,1530,0,1986,0
1500,7615,0,0,3,1150,350,1984,0
1720,7200,0,0,3,1220,500,1974,0
2920,11440,0,0,3,2920,0,2003,0
910,4500,0,0,3,910,0,1948,1994
1050,4160,0,0,4,1050,0,1925,1968
1540,7800,0,0,3,1540,0,2004,2003
1210,7440,0,0,3,1210,0,1949,1998
2650,11455,0,0,3,1400,1250,1961,2004
1990,3990,0,0,5,1130,860,1912,0
2660,8737,0,4,5,1470,1190,1969,0
4060,9734,0,4,3,2150,1910,1977,2004
2300,23345,0,0,5,1170,1130,1967,0
2630,16411,0,0,4,1650,980,1974,0
770,8149,0,0,5,770,0,1948,1985
3790,10669,0,0,3,3790,0,1999,0
2540,7210,0,0,4,1600,940,1979,0
2500,8500,0,0,4,1600,900,1978,2000
2150,7303,0,0,3,2150,0,2005,0
1670,9600,0,0,5,1670,0,1961,0
1800,12669,0,0,3,1800,0,1956,1990
2070,12708,0,0,3,2070,0,1996,0
830,2820,0,0,4,830,0,1920,0
2370,9619,0,0,4,1650,720,1973,0
1010,5400,0,0,3,1010,0,1959,1989
1420,4500,0,0,3,1420,0,1959,1989
2120,8701,0,0,4,2120,0,1960,2001
2020,7029,0,0,4,1430,590,1979,0
1520,2208,0,0,3,1040,480,2007,0
820,6250,0,0,4,820,0,1922,0
1690,1553,0,0,3,1690,0,2007,0
2260,11305,0,0,3,1130,1130,1986,0
1830,7897,0,0,4,1290,540,1986,0
1350,11150,0,0,3,1110,240,1995,0
3280,4000,0,0,3,2440,840,2003,0
2770,45514,0,0,4,2770,0,1989,0
2770,8642,0,0,4,2770,0,1987,0
2460,5091,0,0,3,2460,0,2003,0
4720,32467,0,2,3,3190,1530,1998,2006
1250,8100,0,0,4,1250,0,1947,1988
1710,7225,0,0,4,1710,0,1988,0
1840,5101,0,0,5,1040,800,1952,1998
2000,5962,0,0,3,2000,0,1999,0
650,15364,0,0,4,650,0,1967,0
1020,9072,0,0,3,920,100,1930,1997
1500,18540,0,0,3,1500,0,1950,2005
2060,4399,0,0,3,2060,0,2007,0
1810,29308,0,0,3,950,860,1983,2009
3810,28176,0,4,5,3810,0,1969,0
1650,4000,0,0,4,950,700,1947,1988
1540,704,0,0,3,1540,0,2011,0
2080,5244,0,0,3,1190,890,1959,1989
2430,5500,0,0,3,1810,620,1989,0
1750,10284,0,0,4,1750,0,1943,0
1770,33224,0,0,4,1770,0,1968,0
1710,2300,0,0,3,1570,140,2005,0
2740,88426,0,0,3,2740,0,1991,0
2730,17240,0,0,5,1660,1070,1958,0
2437,5136,0,0,3,2437,0,2011,0
3290,6203,0,0,3,3290,0,2008,0
2910,5260,0,0,3,2910,0,2012,1912
1630,7599,0,0,3,1630,0,2006,0
4410,5104,0,0,3,3400,1010,2006,0
1780,1487,0,0,3,1600,180,2006,0
1540,1487,0,0,3,1540,0,2011,0
1420,1189,0,0,3,1420,0,2006,0
2680,9750,0,0,4,1610,1070,1979,0
1750,9750,0,0,3,1350,400,1961,2004
2170,4912,0,0,3,2170,0,2003,0
2390,9966,0,0,5,1360,1030,1977,0
2400,5350,0,0,4,1460,940,1929,0
1690,4250,0,0,3,1020,670,1967,2011
3250,6000,0,0,3,2500,750,2001,0
4610,40202,0,0,4,2500,2110,1980,0
2440,15349,0,1,4,2440,0,1957,2001
1290,3870,0,0,5,1290,0,1916,0
2000,4676,0,0,3,1250,750,1916,1986
1050,7500,0,0,3,1050,0,1900,2005
2340,3784,0,0,3,2340,0,2008,0
2210,7665,0,0,4,2210,0,1968,0
2920,5568,0,0,3,2320,600,1906,2014
3150,219978,0,0,4,3000,150,1990,0
3590,6402,0,0,3,3590,0,1999,0
1910,5000,0,0,3,1910,0,2005,0
3110,35235,0,0,4,3110,0,1983,0
2440,4750,0,0,3,1450,990,2006,0
1330,8400,0,0,3,1330,0,1962,2003
1460,22651,0,0,4,1460,0,1961,2001
3902,3880,0,4,4,2782,1120,1977,0
5180,17811,0,2,3,4070,1110,2001,0
1150,2064,0,0,3,1150,0,2004,2003
1920,10403,0,0,3,1370,550,1959,1989
2520,53143,0,0,3,2520,0,1988,2000
970,3400,0,0,3,970,0,1924,2011
2490,7666,0,0,4,1490,1000,1989,0
1680,8424,0,0,3,1680,0,1993,0
1150,4825,0,0,4,1150,0,1957,2001
1980,7931,0,0,4,1160,820,1983,0
2070,13084,0,0,4,1700,370,1967,0
5660,193593,0,0,3,4100,1560,2001,0
2420,10962,0,0,3,1530,890,1977,2004
2610,4781,0,0,3,2610,0,2009,0
2810,10840,0,2,4,2070,740,1994,0
1510,10384,0,0,2,1030,480,1976,0
1910,4800,0,0,3,1080,830,1959,1989
1700,51649,0,0,5,1700,0,1931,0
2020,10720,0,0,4,1420,600,1976,1992
2340,4206,0,0,5,1170,1170,1917,0
1463,868,0,0,3,1463,0,2003,0
1430,3840,0,0,3,950,480,1945,2010
1180,12324,0,0,3,800,380,1981,2013
4400,15580,0,0,3,3390,1010,2003,0
1610,6176,0,0,3,1610,0,1994,0
1480,14250,0,0,3,1480,0,1996,0
2670,10338,0,0,3,2670,0,1987,2000
1830,29110,0,0,3,1230,600,1990,2009
920,4095,0,0,4,920,0,1914,1945
1150,19200,0,0,4,1150,0,1908,0
1190,7408,0,0,3,830,360,1941,1994
4160,35654,0,0,3,2760,1400,1973,2013
2370,12753,0,0,3,2370,0,2001,0
1660,3800,0,0,3,1660,0,1926,2003
1480,8381,0,0,4,1480,0,1968,0
2390,6426,0,0,3,2390,0,1999,0
1690,1432,0,0,3,1360,330,2008,0
1010,7560,0,0,3,1010,0,1958,2004
3500,8547,0,0,3,2500,1000,1994,0
2330,7642,0,0,3,1800,530,1990,2009
1890,9450,0,0,3,1090,800,1957,2000
2000,6032,0,2,3,1300,700,1959,1989
1130,10650,0,0,3,1130,0,1954,2005
1670,9886,0,0,5,1670,0,1947,0
2600,5540,0,0,3,2600,0,2004,2003
1560,31299,0,0,4,1560,0,1965,0
1170,5360,0,0,3,1170,0,1919,2001
2100,4237,0,0,3,2100,0,2006,0
1710,11500,0,0,3,1210,500,1978,0
2420,5773,0,0,3,2420,0,2005,0
1370,4000,0,0,3,1370,0,1951,1994
2660,3900,0,0,4,1480,1180,1923,0
2260,3713,0,0,3,2260,0,2003,0
2070,4500,0,0,3,2070,0,2004,2003
4670,43950,0,0,3,4670,0,1989,0
1500,13500,0,0,4,1500,0,1968,0
2658,3960,0,0,3,2658,0,2014,0
2700,5150,0,0,3,2700,0,2007,0
1530,1245,0,0,3,1050,480,2014,0
1480,1485,0,0,3,1280,200,2007,0
1390,1080,0,0,3,1140,250,2006,0
1660,3990,0,0,3,1660,0,2009,0
2050,4185,0,0,3,2050,0,2011,0
1550,7740,0,0,3,1550,0,1954,2005
1900,8600,0,0,4,1900,0,1975,0
2820,6180,0,0,3,2050,770,2013,1923
1490,4080,0,0,3,930,560,1956,2001
1750,12500,0,0,3,1150,600,1954,2005
2040,6034,0,0,3,2040,0,1990,2009
1900,5000,0,0,3,1640,260,1926,2003
1910,12596,0,0,3,1340,570,1977,2004
1560,14333,0,0,4,1560,0,1953,1983
1470,6250,0,3,4,1070,400,1939,1989
2700,9994,0,3,4,1350,1350,1959,0
3450,11240,0,3,4,2430,1020,1960,2001
1970,9600,0,0,4,1300,670,1967,0
2670,12187,0,0,3,2670,0,1986,0
2550,13458,0,0,3,2550,0,1990,2009
1720,4011,0,0,4,1720,0,1904,0
4270,6002,0,3,3,3180,1090,2004,2003
2170,16600,1,2,3,1130,1040,1979,2014
2840,9354,0,0,3,2840,0,1990,2009
3270,50994,0,0,4,2720,550,1983,0
1480,7040,0,0,3,1480,0,1974,0
2440,8000,0,0,4,1240,1200,1972,0
2880,5750,0,0,5,1710,1170,1928,1970
1730,9610,0,0,3,1380,350,1962,2003
1260,4080,0,0,5,1260,0,1926,0
2230,9900,0,0,5,2230,0,1959,0
2460,16940,0,4,4,1930,530,1936,0
2050,94525,0,0,4,1250,800,1959,0
2030,2805,0,0,3,1720,310,2001,0
810,4800,0,0,3,810,0,1948,1994
1840,8100,0,0,4,920,920,1953,1983
1730,40250,0,0,4,1730,0,1983,0
2280,6815,0,0,3,2280,0,2002,0
2630,6326,0,0,3,2630,0,2008,0
2270,23900,0,0,3,1820,450,1975,0
1020,7020,0,0,4,1020,0,1953,1983
1990,2175,0,0,3,1680,310,2005,0
2680,15508,0,0,3,2680,0,1999,0
1980,3300,0,0,4,1140,840,1926,1993
2400,6975,0,0,3,2400,0,1993,0
780,5000,0,0,4,780,0,1943,0
980,5000,0,0,3,980,0,1940,1996
1210,103237,0,0,2,1210,0,1918,1960
4600,19831,0,3,3,2300,2300,1956,2013
1480,1961,0,0,3,1480,0,2005,0
1320,14250,0,0,4,1320,0,1954,1979
4400,18500,0,3,5,2250,2150,1963,0
3010,3600,0,0,3,2370,640,1999,0
2260,9568,0,0,3,1780,480,1985,0
1880,14653,0,0,3,1880,0,1978,0
1370,9900,0,0,4,1370,0,1983,0
2720,3800,0,0,5,1800,920,1919,1934
1740,5400,0,0,4,990,750,1946,1989
2560,5593,0,0,3,2560,0,2001,0
2690,5557,0,0,3,2690,0,2012,1912
3240,5562,0,0,3,3240,0,2013,1923
2430,4747,0,0,3,2430,0,2008,0
1405,1073,0,0,3,1140,265,2007,0
3030,7679,0,0,3,3030,0,2014,0
4150,8436,0,0,3,4150,0,2014,0
1730,2940,0,0,3,1730,0,1985,0
3820,53173,0,0,4,2040,1780,1974,0
3070,6432,0,0,3,3070,0,2006,0
1780,4169,0,0,3,1780,0,1994,0
1811,4381,0,0,3,1811,0,2007,0
2450,62290,0,0,3,2450,0,1976,0
2300,7398,0,0,3,2300,0,2001,0
1440,3225,0,0,3,960,480,1915,0
2370,9360,0,0,4,2370,0,1979,0
4420,7850,1,4,3,3150,1270,2001,0
1300,3550,0,0,3,1300,0,1927,2011
2870,4369,0,0,3,2090,780,2007,0
3400,7200,0,2,3,2470,930,2009,0
1410,5060,0,0,4,910,500,1956,0
1640,13500,0,0,3,1110,530,1940,1996
3190,7399,0,0,3,3190,0,2006,0
2380,13435,0,0,3,2380,0,1992,0
2260,4165,0,0,3,2260,0,2005,0
1240,8050,0,0,4,1240,0,1978,2000
4220,26784,0,0,3,2110,2110,1958,2006
4250,19387,0,2,4,3260,990,1972,0
1860,7963,0,0,3,1200,660,1963,2008
2850,10474,0,0,4,1730,1120,1954,1979
2470,36445,0,0,4,2470,0,1980,0
2210,8000,0,0,4,2210,0,1969,0
1920,7665,0,0,4,1500,420,1975,0
3150,7778,0,0,3,3150,0,2000,0
2700,7875,0,0,4,2700,0,1968,0
2190,7149,0,1,4,1240,950,1963,0
1380,951,0,0,3,1380,0,2006,0
2520,5753,0,0,4,1510,1010,1928,0
1300,8800,0,0,4,1300,0,1963,0
2220,6500,0,3,4,2220,0,1964,0
730,7528,0,0,3,730,0,1946,0
3300,15907,0,0,5,3300,0,1985,0
4130,112521,0,0,3,4130,0,1978,0
2670,47480,0,3,3,2670,0,1981,2013
1980,5909,0,0,3,1980,0,2003,0
740,5995,0,0,4,740,0,1949,1985
2050,3520,0,0,4,1070,980,1977,0
1230,7500,0,0,3,1230,0,1987,2000
1210,1420,0,0,3,1210,0,2008,0
1890,7200,0,0,4,1230,660,1973,0
1870,6275,0,0,3,1870,0,2003,0
1330,6301,0,0,3,1330,0,1998,2006
1590,35988,0,0,4,1590,0,1974,0
1710,10800,0,0,4,1710,0,1958,1972
1200,9000,0,2,5,1200,0,1917,0
1140,5100,0,0,3,1140,0,1942,1999
2240,8153,0,0,3,1120,1120,1948,1994
920,6600,0,0,3,920,0,1919,2003
800,5000,0,0,3,800,0,1906,2014
1980,11443,0,0,5,1980,0,1952,1998
2800,12831,0,0,3,2800,0,2001,0
1680,35127,0,0,3,1680,0,1987,2000
2330,9928,0,0,3,2330,0,1998,2006
2240,9886,0,0,4,2240,0,1965,0
2140,8925,0,0,3,2140,0,1991,0
2170,14024,0,0,3,2170,0,1992,0
1150,8686,0,0,4,1150,0,1963,0
2030,3905,0,0,4,1630,400,1926,1993
1350,11805,0,0,3,1350,0,1986,0
910,4635,0,0,4,910,0,1905,0
2700,5100,0,0,4,1440,1260,1968,0
3730,15029,0,2,3,2440,1290,1991,0
2740,16007,0,0,3,2740,0,1984,0
2050,5000,0,0,4,1370,680,1987,0
2390,4500,0,0,3,2390,0,1974,0
1990,7252,0,0,3,1270,720,1999,0
1300,21000,0,0,4,1300,0,1969,0
1330,8912,0,0,3,1330,0,1948,1994
1000,31505,0,0,3,1000,0,1960,2012
2190,14937,0,0,3,2190,0,1993,0
1380,3402,0,0,3,1380,0,1900,2000
2610,33206,0,0,3,2610,0,1988,2000
1060,1241,0,0,3,960,100,2008,0
710,1136,0,0,4,710,0,1943,0
2730,4800,0,0,5,2230,500,1909,1988
2470,131790,0,2,3,2470,0,1937,1999
1760,10780,0,0,3,1760,0,1977,2004
1530,3464,0,0,3,1530,0,1998,2006
1610,158558,0,0,2,1610,0,1948,0
1030,21712,0,0,4,1030,0,1938,0
2800,246114,0,0,3,2800,0,1999,0
1310,2550,0,0,3,780,530,1986,0
3160,34560,0,0,4,3160,0,1981,0
2500,8304,0,0,3,2500,0,1997,0
2070,5386,0,0,4,1140,930,1948,0
1980,9000,0,0,2,1480,500,1978,0
2590,7237,0,0,3,2590,0,2004,2003
1910,16320,0,0,3,1910,0,1934,1978
2630,10100,0,0,4,1580,1050,1967,0
2630,77972,0,0,3,2630,0,2004,2003
1960,4400,0,0,3,1960,0,2006,0
1440,45302,0,0,3,1440,0,1977,2004
2210,16200,0,0,3,1390,820,1958,2004
2350,63162,0,0,4,2350,0,1994,0
1590,13000,0,0,3,1590,0,1944,0
1500,1249,0,0,3,1240,260,2004,2003
1900,6224,0,0,3,1900,0,2005,0
2370,3692,0,0,3,2370,0,2013,1923
1720,1715,0,0,3,1240,480,2004,2003
2020,7560,0,0,4,2020,0,1960,2001
1340,1210,0,0,3,1120,220,2008,0
1800,2700,0,0,3,1800,0,2011,0
1480,1590,0,0,3,1150,330,2010,0
2750,7807,0,0,5,2250,500,1916,0
3760,28040,0,0,3,3760,0,1983,2009
2540,4694,0,0,3,2540,0,2005,0
1760,26055,0,0,3,920,840,1979,2014
3000,25341,0,0,3,3000,0,1995,0
1930,9643,0,0,4,1930,0,1992,0
3040,7000,0,0,3,3040,0,2001,0
860,3880,0,0,4,860,0,1916,0
1420,7650,0,0,4,1100,320,1984,0
2080,3880,0,0,5,1160,920,1954,0
1560,4200,0,0,3,1560,0,2003,0
1960,7133,0,0,3,1960,0,2002,0
1620,4500,0,0,4,1620,0,1926,1993
3670,10583,0,0,5,2060,1610,1952,1998
1930,8400,0,0,3,1030,900,1971,0
1290,1286,0,0,3,1290,0,2000,0
1970,15247,0,0,3,1450,520,1986,0
1540,6909,0,0,4,920,620,1955,2009
2180,3870,0,0,3,1020,1160,1900,2005
1490,224334,0,2,3,1490,0,1983,2009
2220,10275,0,0,3,1640,580,1980,0
2430,9133,0,0,4,1410,1020,1978,2000
1392,43710,0,0,4,1392,0,1978,2000
1120,2685,0,0,3,860,260,1939,1969
1390,10800,0,0,4,1390,0,1941,1998
2040,7281,0,0,3,1020,1020,1962,2003
2830,7500,0,0,3,2460,370,1923,1998
3020,8302,0,0,4,3020,0,1994,0
2290,14800,0,0,3,1620,670,1965,1993
1210,11100,0,0,4,1210,0,1955,2009
2510,6320,0,0,3,2510,0,1996,0
2320,4322,0,0,3,1140,1180,1910,2006
970,6600,0,0,3,970,0,1965,1993
1820,5500,0,0,4,1620,200,1957,2001
970,7742,0,0,4,970,0,1967,0
1740,3622,0,0,4,950,790,1924,0
1590,7560,0,0,3,1130,460,1984,0
1380,5000,0,0,3,870,510,1943,2002
1680,11123,0,0,3,1130,550,1959,1989
1220,3000,0,0,3,920,300,1926,2003
1651,18200,0,0,3,1651,0,1946,0
1330,9200,0,0,4,1330,0,1973,0
2940,4622,0,0,4,2230,710,1988,0
1410,1246,0,0,3,1410,0,2005,0
1100,3598,0,0,4,1100,0,1926,1993
1530,7200,0,0,3,1530,0,1975,0
5270,17232,0,1,3,4010,1260,1977,2003
2110,5150,0,0,5,1080,1030,1919,1934
1720,8750,0,0,3,860,860,1971,0
1800,5001,0,0,3,1800,0,1996,0
2210,9427,0,0,3,2210,0,1999,0
2560,9731,0,0,4,2560,0,1973,0
1010,7719,0,0,3,1010,0,1981,2013
3340,12248,0,1,3,2470,870,1998,2006
1740,11075,0,0,3,1740,0,1965,1993
1320,7200,0,0,5,1320,0,1975,0
1520,8625,0,0,3,1520,0,1976,0
2010,9480,0,0,3,1570,440,1951,1994
2440,3427,0,0,3,1990,450,2000,0
2550,20875,0,0,4,1610,940,1953,1983
1010,9450,0,0,4,1010,0,1959,0
1780,6771,0,0,3,1230,550,1990,2009
2180,4976,0,2,4,1680,500,1930,0
2750,7500,0,1,3,2150,600,1937,1997
3490,7024,0,0,3,3490,0,2006,0
2550,45254,0,0,3,2550,0,2001,0
1870,7189,0,0,3,1270,600,1959,1989
1150,8184,0,0,3,1150,0,1947,2012
2050,11856,0,0,3,1460,590,1962,2003
1940,6555,0,0,3,1940,0,1990,2009
3630,6000,0,0,3,2470,1160,2004,2003
1890,9100,0,0,4,1890,0,1952,0
1630,10375,0,0,5,1630,0,1968,0
2440,5000,0,0,3,1340,1100,1954,2005
3100,9825,0,2,4,3100,0,1950,1982
2090,6045,0,0,3,2090,0,2000,0
920,9812,0,0,4,920,0,1962,0
1580,5000,0,0,3,1580,0,1926,2003
1760,8400,0,0,4,1460,300,1960,2001
2530,7563,0,0,3,1440,1090,1978,0
2490,9714,0,0,4,1400,1090,1983,0
3870,35889,0,0,3,2530,1340,2001,0
2732,9500,0,2,4,1870,862,1975,0
3230,3825,0,0,3,2480,750,2014,0
2930,14980,0,3,3,2930,0,2013,1923
3510,9364,0,0,3,3510,0,2001,0
2580,3909,0,0,3,2580,0,2013,1923
1060,1208,0,0,3,940,120,2005,0
2790,8853,0,0,3,2790,0,2013,1923
2009,5000,0,0,3,2009,0,2014,0
2880,8364,0,0,3,2880,0,2006,0
710,1157,0,0,4,710,0,1943,0
2070,13241,0,0,5,1270,800,1910,0
1370,8336,0,0,5,1370,0,1964,0
1730,8400,0,0,4,1400,330,1980,0
1680,5000,0,0,3,980,700,1950,2005
1350,10096,0,2,4,1350,0,1952,0
1510,9078,0,0,4,1510,0,1959,0
1860,6607,0,0,3,1860,0,1989,0
3440,4500,0,0,3,3280,160,2007,0
4250,4400,0,0,4,3020,1230,1902,0
860,3874,0,0,4,860,0,1931,0
1640,4080,0,0,3,840,800,1921,2000
1295,1093,0,0,3,1105,190,2007,0
1790,27427,0,0,3,1130,660,1978,0
2210,6300,0,0,5,2210,0,1916,0
10040,37325,1,2,3,7680,2360,1940,2001
940,10368,0,0,3,940,0,1965,1993
1160,8906,0,0,3,1160,0,1962,2003
1990,3984,0,0,3,1990,0,2004,2003
1050,6300,0,0,3,1050,0,1942,1999
1030,5750,0,0,5,1030,0,1928,1970
1420,2581,0,0,3,1420,0,2004,2003
2690,4000,0,3,4,2120,570,1909,1989
3760,29224,0,0,3,3760,0,1987,2000
700,4700,0,0,5,700,0,1953,0
2100,5107,0,0,3,1410,690,1999,0
2240,27820,0,0,4,2240,0,1976,1992
3470,32109,0,0,3,3470,0,1995,0
3370,19585,0,0,3,3200,170,1951,1994
2790,230868,0,0,3,2790,0,1989,0
1870,4060,0,0,3,1870,0,2005,0
1520,15090,0,0,4,1520,0,1968,0
750,20339,0,0,4,550,200,1946,1989
1460,11407,0,0,3,1460,0,1954,2005
2600,7465,0,0,3,2600,0,1988,2000
3320,11901,0,0,5,2650,670,1977,0
2340,6000,0,0,4,2340,0,1922,0
890,7200,0,0,3,890,0,1951,1994
1720,5899,0,1,3,1220,500,1986,0
1270,1318,0,0,3,1080,190,2004,2003
2180,7203,0,0,4,2180,0,1989,0
2030,13500,0,0,3,1230,800,1963,2008
2490,17833,0,2,3,1490,1000,1979,2014
1470,5350,0,0,3,980,490,1955,2005
2500,7378,0,0,5,1390,1110,1948,1985
4500,21870,0,0,3,4500,0,2004,2003
1460,1592,0,0,3,1130,330,2006,0
620,8261,0,0,3,620,0,1939,1969
1550,3680,0,0,3,1050,500,1927,2011
1430,1002,0,0,3,1430,0,2002,0
1360,9760,0,0,5,1360,0,1984,0
2210,7557,0,0,3,2210,0,1989,0
2460,5100,0,0,5,1450,1010,1909,1988
2180,15693,0,0,4,1850,330,1979,0
1570,4875,0,0,4,1310,260,1977,0
4140,24190,0,0,3,4140,0,2002,0
1140,5500,0,0,4,1140,0,1908,0
8670,64033,0,4,3,6120,2550,1965,2003
800,15000,0,0,3,800,0,1927,2011
2414,7693,0,0,3,2414,0,2006,0
1160,8813,0,0,3,1160,0,1952,2008
3170,10688,0,2,3,3170,0,2001,0
4210,17258,0,3,3,4210,0,1995,0
2060,4437,0,0,3,1030,1030,1929,0
1640,7201,0,0,3,1640,0,1948,1994
720,6686,0,0,3,720,0,1942,1999
1860,4736,0,0,1,1860,0,1901,0
2810,10986,0,0,3,2810,0,1997,0
2090,9702,0,0,5,1320,770,1965,0
3280,6181,0,0,3,3280,0,2001,0
2090,3610,0,0,5,1790,300,1927,0
2430,14607,0,1,3,1230,1200,1949,1970
2520,49222,0,0,4,2520,0,1978,2000
2510,4125,0,3,5,1590,920,1925,0
3370,6675,0,3,4,1920,1450,1948,0
1640,5280,0,0,5,1640,0,1910,0
2250,7294,0,0,3,2250,0,1994,0
2300,19250,0,0,4,2300,0,1955,2009
1650,2262,0,0,3,1650,0,2010,0
710,1131,0,0,4,710,0,1943,0
2550,8698,0,0,3,2550,0,2007,0
982,846,0,0,3,806,176,2006,0
1630,2520,0,0,3,1630,0,2005,0
2550,4500,0,0,3,2550,0,2009,0
1240,2150,0,0,3,1240,0,2014,0
2456,7566,0,0,3,2456,0,2012,1912
3200,20158,0,0,3,1600,1600,1965,1993
3950,111078,0,0,3,2460,1490,1989,0
2180,7297,0,0,3,2180,0,1984,0
3140,9225,0,2,5,1770,1370,1966,0
4030,10800,0,0,3,4030,0,2006,0
1970,7972,0,3,5,1370,600,1976,0
1940,7642,0,0,3,1940,0,1957,2000
4860,9453,0,1,5,3100,1760,1905,0
3064,4764,0,2,3,3064,0,1990,2009
970,5665,0,0,4,970,0,1908,0
2460,44431,0,0,4,2460,0,1957,2001
3010,6100,0,0,3,3010,0,2005,0
2460,6600,0,2,4,1370,1090,1952,0
2080,11375,0,0,3,2080,0,2002,0
3960,7012,0,0,3,3960,0,2005,0
2490,8124,0,0,3,2490,0,2001,0
2060,6000,0,0,3,2060,0,1903,2005
1330,15678,0,0,3,900,430,1984,0
1600,19200,0,0,4,1600,0,1967,0
820,10450,0,0,4,820,0,1965,0
1200,7680,0,0,3,1200,0,1968,1997
1050,5664,0,0,4,910,140,1947,1988
1910,1501,0,0,3,1530,380,2007,0
1800,6000,0,0,5,900,900,1950,0
2060,8640,0,0,4,2060,0,1966,0
1840,9697,0,0,4,1500,340,1985,0
1250,1103,0,2,3,1250,0,2005,0
1510,4032,0,0,3,1310,200,1935,1974
2300,4600,0,0,4,1340,960,1904,0
1490,7560,0,0,3,1490,0,1966,1963
2820,4608,0,0,3,1450,1370,1967,2011
1130,7840,0,0,4,1130,0,1970,0
3200,7500,0,1,5,1860,1340,1948,1985
1510,5000,0,0,3,1510,0,1909,2004
1970,7500,0,0,3,1970,0,1988,2000
1210,5750,0,0,4,1210,0,1910,0
3280,27441,0,0,3,3280,0,1996,0
2420,17859,0,1,5,1500,920,1979,0
2460,6846,0,0,5,1340,1120,1911,1984
1180,11862,0,0,4,1180,0,1948,0
1900,6400,0,0,5,1410,490,1942,0
1651,1779,0,0,3,1341,310,2008,0
2130,11843,0,0,4,2130,0,1972,0
1430,3000,0,0,3,1300,130,1929,0
5730,44947,0,4,3,4280,1450,1991,0
1910,9244,0,0,4,1910,0,1963,0
2110,11250,0,0,4,2110,0,1961,2001
1630,3780,0,0,4,890,740,1940,2001
2470,35073,0,0,3,2470,0,1989,0
2640,31941,0,0,4,2640,0,1986,0
2990,7420,0,0,3,2990,0,1996,0
2120,9736,0,0,3,2120,0,1988,2000
2050,6420,0,3,3,1730,320,1956,2001
1880,5000,0,0,3,1100,780,1997,0
2790,12523,1,4,4,1600,1190,1977,0
3000,7500,0,0,3,3000,0,1937,1994
2140,7245,0,0,3,2140,0,2003,0
1769,9300,0,0,4,1769,0,1955,2009
1710,6556,0,0,4,1200,510,1926,1993
420,6720,0,0,3,420,0,1922,2008
3270,35445,0,0,3,3270,0,1989,0
2370,10858,0,0,3,2370,0,2003,0
1770,5855,0,0,3,1770,0,2003,0
2210,8465,0,0,3,1490,720,1990,2009
1710,4140,0,0,3,1710,0,2004,2003
2710,4750,0,0,4,1460,1250,1919,1985
2340,2970,0,0,5,2160,180,1925,0
1220,17172,0,0,4,1220,0,1947,1988
1060,9525,0,0,3,1060,0,1966,1963
910,9869,0,0,3,910,0,1957,2000
1880,3880,0,0,4,1090,790,1944,0
1870,5200,0,0,4,1200,670,1937,0
1480,5400,0,0,4,1480,0,1914,1945
1880,7000,0,0,3,1880,0,1993,0
1890,6000,0,0,4,1110,780,1947,1988
1560,7392,0,0,5,1030,530,1972,0
1070,1200,0,0,3,1070,0,1999,0
4410,14380,0,0,3,4410,0,2006,0
1470,1235,0,0,3,1180,290,2008,0
2570,3600,0,0,3,2570,0,2007,0
1170,1011,0,0,3,1170,0,2009,0
2320,4960,0,0,5,1720,600,1926,0
2440,9600,0,0,5,2440,0,1961,0
4120,22370,0,0,3,4120,0,1997,0
1440,5680,0,0,4,1440,0,1978,2000
1340,11070,0,0,4,1340,0,1978,2000
3010,4360,0,0,3,2000,1010,2014,0
1840,8601,0,0,3,920,920,1905,2014
930,7550,0,0,3,930,0,1986,0
4070,115434,0,0,3,4070,0,2002,0
1820,9545,0,0,3,1230,590,1976,0
1280,8184,0,0,4,1280,0,1947,1988
900,4600,0,0,3,900,0,1951,1994
1980,13503,0,2,4,1320,660,1952,0
2010,7575,0,0,3,1220,790,1974,0
2750,4800,0,0,3,1960,790,1905,2005
3140,10875,0,1,3,1940,1200,1939,1969
4200,5800,0,0,4,2910,1290,1906,1990
1900,8540,0,0,3,950,950,1980,0
1830,3000,0,0,3,1430,400,1926,2003
3320,23760,0,0,4,2190,1130,1975,0
2700,10814,0,0,4,1560,1140,1966,0
1290,6566,0,0,5,1290,0,1976,0
1500,8173,0,0,3,1500,0,1997,0
3650,48351,0,0,4,3650,0,1978,2000
1270,6405,0,0,3,1270,0,1944,0
2630,39000,0,0,3,2630,0,1979,2014
1800,26615,0,0,5,1240,560,1987,0
1870,2807,0,0,4,1580,290,1927,0
2540,6365,0,0,3,1870,670,2000,0
1930,8660,0,0,3,1120,810,1981,2013
2770,13500,0,0,3,2770,0,1974,0
2220,5338,0,0,3,2220,0,2001,0
1650,9957,0,0,4,1100,550,1961,2001
3670,54450,0,0,3,3670,0,1999,0
3770,35081,0,0,3,3770,0,1989,0
2350,20820,0,0,4,1800,550,1978,2000
1210,5240,0,0,4,610,600,1983,0
2010,7972,0,0,4,2010,0,1989,0
1580,6065,0,0,3,1580,0,1985,0
710,7200,0,0,3,710,0,1943,2002
1910,5040,0,0,3,1910,0,1971,0
1880,7965,0,0,3,1880,0,2000,0
2280,641203,0,0,3,2280,0,1990,2009
3100,10014,0,2,4,1660,1440,1973,0
2350,4000,0,0,3,2350,0,1993,0
1850,6869,0,2,5,1100,750,1919,1934
2070,8337,0,0,3,2070,0,1997,0
2020,7070,0,0,5,1010,1010,1958,0
1580,12177,0,0,3,1200,380,1981,2013
2690,7947,0,0,3,2690,0,1993,0
2420,10285,0,4,3,1700,720,1958,2004
2540,6660,0,3,4,2340,200,1954,1979
1150,30184,0,0,3,1150,0,1950,2005
3210,12000,0,0,4,1830,1380,1968,0
2040,4627,0,0,3,2040,0,1992,0
1920,4833,0,0,4,1060,860,1921,0
1900,10588,0,0,5,1900,0,1958,0
4310,32093,0,4,5,2510,1800,1982,0
1070,1155,0,0,3,720,350,2005,0
2790,43091,0,0,4,2790,0,1989,0
2860,4442,0,0,3,2860,0,2000,0
2250,8800,0,0,4,1250,1000,1925,1968
3170,3000,0,2,5,1990,1180,1900,0
1460,7200,0,0,3,1260,200,1906,2014
1540,3399,0,0,3,1200,340,1926,2003
2910,6600,0,0,4,1920,990,1900,1988
1180,13927,0,0,5,1180,0,1962,0
1640,7437,0,0,3,1090,550,1948,1994
1520,19672,0,0,3,1020,500,1920,1979
3610,9775,0,0,3,3610,0,2003,0
1400,3814,0,0,3,1400,0,2012,1912
3200,3250,0,0,3,2670,530,2007,0
1384,1287,0,0,3,1144,240,2006,0
1410,1287,0,0,3,1290,120,2005,0
2050,5276,0,0,3,2050,0,2006,0
1750,4779,0,0,3,1750,0,2009,0
1510,6710,0,0,3,1070,440,1972,2002
1930,7214,0,0,3,1930,0,2005,0
2960,41656,0,0,3,2960,0,1985,0
2920,11880,0,0,5,1660,1260,1968,0
1980,5000,0,0,4,1090,890,1923,0
1430,8865,0,0,3,1430,0,1950,2005
2450,4187,0,2,3,2450,0,2010,0
2360,4924,0,0,3,2360,0,2008,0
1890,4838,0,0,3,1730,160,2002,0
2140,9484,0,0,3,1290,850,1953,0
1900,8100,0,0,4,950,950,1940,2001
2700,9122,0,0,3,2700,0,1990,2009
2430,8000,0,0,4,1370,1060,1957,2001
1110,12150,0,0,4,1110,0,1957,2001
2280,15347,0,0,5,2280,0,1960,0
1550,4708,0,0,4,860,690,1949,1985
1530,8925,0,0,3,1530,0,1977,2004
2440,28405,0,0,3,2440,0,2002,0
1760,9602,0,0,3,1760,0,1987,2000
3040,5000,0,3,4,2080,960,1926,1993
1070,8100,0,0,4,1070,0,1957,2001
1990,5560,0,0,4,1100,890,1939,1989
1090,4000,0,0,3,970,120,1951,1994
1890,6938,0,0,3,1890,0,1919,2001
1000,9150,0,0,3,1000,0,1969,2010
1770,8235,0,0,3,1030,740,1960,2012
2360,6250,0,2,3,1460,900,1960,2012
3380,108900,0,0,3,2700,680,1999,0
1700,3150,0,0,3,1700,0,2005,0
1600,4000,0,0,5,850,750,1918,0
2050,6360,0,0,3,2050,0,1988,2000
1210,1040,0,0,3,1210,0,2014,0
1940,6355,0,0,3,1200,740,2007,0
1810,8750,0,0,2,1110,700,1967,0
1690,4080,0,0,4,870,820,1984,0
1800,2970,0,0,4,1000,800,1923,0
3280,6603,0,0,3,3280,0,2007,0
4290,175421,0,0,3,4290,0,2004,2003
1150,9600,0,0,3,1150,0,1979,2014
880,1805,0,0,3,880,0,1999,0
1720,8100,0,0,3,1720,0,1907,1983
1510,8000,0,0,4,1510,0,1956,0
1240,3000,0,0,3,1040,200,1908,1988
1580,9581,0,0,3,1580,0,1953,0
2170,7737,0,0,3,2170,0,1987,2000
2500,4950,0,0,3,2500,0,2010,0
960,2640,0,0,3,760,200,1908,1988
3030,8507,0,0,3,3030,0,2003,0
1540,10800,0,0,5,770,770,1947,0
1890,32340,0,3,3,1890,0,1976,0
2810,9800,0,0,4,1710,1100,1973,0
3530,8400,0,0,5,2630,900,1958,0
1100,8536,0,0,4,1100,0,1957,2001
1940,9775,0,2,3,1440,500,1975,0
2300,9521,0,0,3,2300,0,2003,0
2110,3600,0,0,3,2110,0,2005,0
1220,10580,0,0,3,1220,0,1965,1993
1750,12325,0,0,4,1470,280,1968,0
1230,8056,0,0,4,1230,0,1949,1985
3100,23790,0,0,3,3100,0,2002,0
1830,65340,0,0,3,1520,310,1991,0
2640,7096,0,0,3,2640,0,2003,0
1840,2774,0,0,3,1060,780,1900,2005
3190,14565,0,0,3,3190,0,1990,2009
1120,2000,0,0,3,1120,0,1910,2006
1760,6723,0,0,3,1160,600,1958,2004
1590,9912,0,0,3,1590,0,2000,0
2120,9603,0,0,3,2120,0,1985,0
2240,9826,0,0,4,1370,870,1988,0
890,2100,0,0,4,760,130,1919,1985
2940,5432,0,3,4,2440,500,1978,2000
1220,7300,0,0,3,1220,0,1973,2013
2670,7500,0,0,4,1640,1030,1966,0
1120,2300,0,0,4,820,300,1912,1989
3130,139392,0,0,4,3130,0,1981,0
1740,7500,0,0,4,1220,520,1976,1992
3290,5414,0,1,3,2360,930,2006,0
1770,5720,0,0,4,1140,630,1926,1993
2960,5054,0,0,3,2960,0,2006,0
1200,4880,0,0,3,980,220,1943,2002
2400,6000,0,0,3,2400,0,1913,1945
2690,6164,0,0,3,2690,0,2002,0
3550,11780,0,0,4,2960,590,1948,0
1310,12196,0,0,3,1310,0,1970,2014
2610,4160,0,0,5,1910,700,1910,0
2760,8015,0,0,4,1600,1160,1960,2001
1410,7998,0,0,4,1410,0,1940,2001
1960,7950,0,0,4,1960,0,1967,0
1212,1174,0,0,3,1212,0,2004,2003
2220,9496,0,0,4,1490,730,1954,1979
2040,109336,0,0,4,2040,0,1973,0
2800,19168,0,0,3,2800,0,1992,0
2040,6000,0,0,3,1340,700,1957,2000
3070,34412,0,3,4,2070,1000,1950,1983
830,26329,1,3,4,830,0,1928,0
4140,7089,0,0,3,3160,980,2003,0
2340,4500,0,0,3,2340,0,2009,0
1420,1282,0,0,3,1420,0,2006,0
2670,3738,0,0,3,1720,950,2013,1923
1880,6008,0,0,3,1880,0,2009,0
3450,6184,0,0,3,3450,0,2014,0
1200,1400,0,0,3,1200,0,2005,0
3430,9870,0,0,3,3430,0,2014,0
1350,1186,0,0,3,1120,230,2007,0
2570,9962,0,0,3,2570,0,2006,0
2840,4637,0,0,3,2840,0,2008,0
2650,5600,0,0,3,2650,0,2014,0
1980,2674,0,0,3,1980,0,2007,0
1280,7524,0,0,4,1280,0,1988,0
2610,7091,0,0,3,2610,0,1987,2000
3010,12611,0,0,3,3010,0,1994,0
930,7129,0,0,3,930,0,1948,1994
1180,7000,0,0,4,1180,0,1977,0
1710,9100,0,0,4,1320,390,1926,1993
1380,7476,0,0,3,1380,0,1989,0
1190,7280,0,0,4,1190,0,1968,0
1870,5909,0,0,3,1270,600,1986,0
3130,4797,0,0,3,2570,560,2014,0
900,5100,0,0,4,900,0,1909,1989
1880,7400,0,0,3,1480,400,1968,1997
3010,4887,0,3,4,1940,1070,1951,1996
2280,5750,0,1,4,1150,1130,1985,0
2970,21907,0,0,3,2970,0,1998,2006
1620,3196,0,0,3,1620,0,2008,0
1550,3000,0,0,3,1350,200,1918,0
2240,78225,0,0,5,2240,0,1976,0
2830,6536,0,0,3,2830,0,1989,0
2890,21780,0,0,3,2890,0,2000,0
1990,5948,0,0,3,1990,0,1991,0
1370,8719,0,0,3,1370,0,1982,0
1088,1360,0,0,3,1088,0,1983,2009
1740,9344,0,0,3,1180,560,1978,0
1730,9000,0,0,3,1370,360,1978,0
1800,8100,0,0,3,1800,0,1998,2006
1440,12888,0,2,3,1090,350,1958,2004
1720,2800,0,0,4,1200,520,1926,1993
2800,7350,0,0,3,2800,0,1995,0
2300,6009,0,0,3,2300,0,2005,0
2030,11585,0,0,4,1590,440,1967,0
740,6180,0,0,3,740,0,1948,1994
9640,13068,1,4,3,4820,4820,1983,2009
1920,13787,0,0,4,1220,700,1966,0
2490,12929,0,0,3,2490,0,1983,2009
1380,4800,0,0,3,1380,0,1948,1994
1530,9406,0,0,3,1270,260,1993,0
2420,1923,0,2,3,1840,580,2006,0
2150,37647,0,0,3,2150,0,1991,0
1610,9600,0,0,5,1610,0,1967,0
2650,3060,0,0,3,2060,590,2001,0
2700,35362,0,0,5,2700,0,1976,0
1270,20700,0,0,2,1150,120,1948,0
3150,38865,0,0,3,2480,670,1986,0
2010,10760,0,0,3,2010,0,1985,0
860,5060,0,0,3,860,0,1927,2011
1410,7466,0,0,3,1410,0,1983,2009
1700,7532,0,0,3,1700,0,1987,2000
2570,6251,0,0,3,2570,0,2000,0
1230,932,0,0,3,1020,210,2004,2003
4170,9748,0,0,3,4170,0,2004,2003
1180,1262,0,0,3,1180,0,2010,0
1430,7347,0,0,3,820,610,1980,0
1450,8400,0,0,4,1450,0,1962,0
2180,7700,0,0,3,1480,700,1961,2004
2210,7079,0,0,3,2210,0,1993,0
1480,7276,0,0,4,940,540,1978,2000
2340,3477,0,1,5,1170,1170,1971,0
3860,18334,0,0,3,3120,740,1996,0
2300,4637,0,0,3,2300,0,2008,0
1450,7375,0,0,3,1010,440,1968,1997
1380,953,0,0,3,1380,0,2006,0
2470,3811,0,0,3,2470,0,1999,0
2030,18295,0,0,4,2030,0,1975,0
1440,13300,0,0,3,1440,0,1948,1994
1160,6134,0,0,3,1160,0,1998,2006
1580,3840,0,0,3,1580,0,1908,1988
1430,1425,0,0,3,995,435,2006,0
1494,19271,1,4,3,1494,0,1943,1997
1930,7207,0,0,4,1360,570,1988,0
2740,6360,0,3,3,1370,1370,1953,0
1880,3800,0,0,5,1030,850,1927,0
2590,7720,0,0,3,2590,0,1988,2000
2140,11266,0,0,3,2140,0,1986,0
1870,6000,0,0,3,1870,0,1956,2001
1230,3800,0,0,3,1230,0,1928,1954
2340,6896,0,0,3,2340,0,2001,0
2880,7599,0,2,3,1710,1170,1958,2002
880,6600,0,0,5,880,0,1945,0
3040,7232,0,0,3,3040,0,2003,0
1120,7104,0,0,3,1120,0,1946,0
1380,3600,0,0,3,1380,0,2013,1923
1660,9760,0,0,3,1660,0,1994,0
2500,5568,0,0,5,2500,0,1905,0
2940,10382,0,0,4,2940,0,1991,0
1670,3315,0,0,3,1670,0,2005,0
2630,7505,0,0,3,2630,0,1994,0
2250,7412,0,0,4,1480,770,1975,0
1320,7000,0,0,4,1320,0,1967,0
4100,22798,0,3,5,2540,1560,1934,1979
4340,4947,0,3,3,3060,1280,1993,0
3700,20570,0,0,4,1850,1850,1976,1992
2700,10875,0,0,4,1540,1160,1962,0
980,7200,0,0,4,980,0,1950,1983
2650,11520,0,0,3,2110,540,1988,2000
3670,4000,0,1,3,2800,870,1964,2000
2960,12420,0,2,4,1480,1480,1952,0
3070,7201,0,0,3,3070,0,2006,0
1413,3600,0,0,3,1413,0,2011,0
1260,1347,0,0,3,1260,0,2005,0
1680,2229,0,0,3,1680,0,2007,0
1230,1238,0,0,3,1080,150,2009,0
4360,6240,0,3,3,2960,1400,2008,0
4420,16526,0,0,3,4420,0,2013,1923
2770,6278,0,0,3,1980,790,2006,0
2910,10204,0,0,3,2910,0,1990,2009
4290,12103,0,3,3,2690,1600,1997,0
1600,26977,0,0,3,1600,0,2005,0
1820,6753,0,0,3,1820,0,1994,0
6050,230652,0,3,3,6050,0,2001,0
1700,8432,0,0,3,1230,470,1977,2004
790,11234,0,0,4,790,0,1942,1982
1720,9000,0,0,4,1320,400,1969,0
990,10723,0,0,5,990,0,1960,0
1770,9011,0,0,5,1050,720,1983,0
1260,8092,0,0,3,1260,0,1986,0
3640,10576,0,0,3,3640,0,1999,0
2040,6000,0,0,5,1120,920,1958,0
1980,10800,0,0,5,990,990,1948,1985
3600,17300,0,0,4,2410,1190,1968,0
4270,43386,0,0,3,2680,1590,1991,0
2030,9600,0,0,3,1430,600,1947,2012
1689,1388,0,0,3,1689,0,2008,0
2870,4461,0,0,3,1650,1220,1976,0
1270,4800,0,0,3,1270,0,1952,2014
2790,7938,0,0,3,2790,0,1997,0
3850,16249,0,2,3,3030,820,2002,0
1560,9361,0,0,4,1360,200,1936,0
1180,4080,0,0,4,760,420,1928,0
1820,8118,0,0,4,1080,740,1980,0
1260,4500,0,0,3,1260,0,1926,2003
2640,6715,0,0,3,1680,960,1991,0
1100,4200,0,0,3,1100,0,1954,2005
1950,6871,0,0,3,1950,0,1997,0
1380,8682,0,0,4,1380,0,1966,0
2200,7000,0,0,4,1280,920,1977,0
2050,7100,0,0,3,1050,1000,1963,2008
2795,15101,0,0,3,2795,0,1996,0
2050,34222,0,0,4,2050,0,1989,0
6430,27517,0,0,3,6430,0,2001,0
2150,7171,0,0,4,1460,690,1970,0
1970,8200,0,0,5,1420,550,1963,0
2660,12672,0,0,4,1740,920,1960,2001
720,4800,0,0,3,720,0,1914,1996
2410,4780,0,0,3,2410,0,2000,0
2020,5500,0,3,3,1790,230,1937,1999
1080,9435,0,0,3,1080,0,1958,2004
1180,14292,0,0,3,1180,0,1981,2013
660,5000,0,0,3,660,0,1915,0
2920,9370,0,0,4,1620,1300,1981,0
4850,12445,1,4,5,3850,1000,1989,0
1080,8580,0,0,3,1080,0,1900,2005
1670,6900,0,0,3,1170,500,1978,0
1370,5080,0,0,3,1120,250,1931,0
3450,28324,0,0,5,2350,1100,1972,0
1970,10500,0,0,3,1820,150,1961,2004
2290,6738,0,0,3,2290,0,1996,0
2240,7543,0,0,3,1140,1100,1966,1963
1240,6400,0,1,4,1060,180,1938,0
2420,43177,0,4,4,1690,730,1989,0
3260,58806,0,0,4,3260,0,1969,0
670,10920,0,0,3,670,0,1942,1999
3160,10000,0,0,4,3160,0,1980,0
1990,6350,0,0,3,1990,0,1967,2011
4680,9700,0,0,3,3360,1320,2005,0
1700,3575,0,0,3,1700,0,2000,0
2807,9430,0,0,3,2807,0,1996,0
1770,9375,0,0,4,1170,600,1968,0
2570,9000,0,0,4,1590,980,1979,0
3450,16200,0,0,3,3450,0,1983,2009
1670,7700,0,0,3,1170,500,1972,2002
1050,6150,0,0,4,950,100,1928,0
1910,7683,0,0,3,1910,0,1987,2000
910,7700,0,0,4,910,0,1971,0
2480,12070,0,0,3,2480,0,1978,0
1820,8867,0,0,3,1820,0,1921,2000
2920,7700,0,0,3,2920,0,2003,0
1870,11411,0,0,4,1170,700,1961,2001
3810,9792,0,0,3,3810,0,1938,2013
2190,4080,0,0,3,1800,390,1918,0
1730,6368,0,0,3,1730,0,1993,0
2220,9360,0,0,4,1110,1110,1968,0
1320,8114,0,0,3,1320,0,1951,1994
1510,4800,0,2,3,860,650,1925,2011
2120,4080,0,0,3,2120,0,2003,0
1690,4500,0,0,3,1690,0,2004,2003
1360,1419,0,0,3,1040,320,2007,0
3250,5000,0,0,3,3250,0,2008,0
1490,1294,0,0,3,1220,270,2010,0
1930,6360,0,0,3,1930,0,2013,1923
2020,5501,0,0,3,2020,0,2010,0
1584,2800,0,0,3,1584,0,2012,1912
3170,8523,0,0,3,3170,0,2008,0
3870,10046,0,0,3,3870,0,2005,0
1430,923,0,0,3,1410,20,2008,0
1380,1120,0,0,3,1380,0,2008,0
2610,4595,0,0,3,2610,0,2008,0
1540,1428,0,0,3,1540,0,2013,1923
1940,9000,0,0,4,970,970,1948,0
2160,3000,0,0,3,1260,900,1909,2011
1530,8750,0,0,4,1530,0,1968,0
1440,7210,0,0,3,1440,0,1983,2009
2640,8625,0,0,3,2640,0,1987,2000
3620,5131,0,3,4,2350,1270,1927,0
2850,4650,0,0,3,2850,0,2004,2003
1260,4377,0,0,4,1260,0,1947,1988
1610,11200,0,0,3,1610,0,1955,2005
1360,5980,0,0,3,1360,0,1945,2008
2496,8058,0,0,3,2496,0,1998,2006
2160,9593,0,0,3,2160,0,1969,2010
1320,3625,0,0,3,1320,0,1900,2005
2540,7089,0,0,3,2540,0,2004,2003
2620,18362,0,0,4,1870,750,1956,0
1140,8340,0,0,3,1140,0,1960,2012
1790,42399,0,0,4,1790,0,1990,0
2440,3600,0,0,4,2440,0,1902,0
2140,7200,0,0,4,1480,660,1966,0
1330,5412,0,0,5,1330,0,1905,0
2590,7910,0,0,3,2590,0,2001,0
4750,13912,0,2,3,3600,1150,2005,0
1620,9205,0,0,5,850,770,1921,0
2440,34290,0,0,3,2440,0,1987,2000
2020,10744,0,0,5,1270,750,1954,0
1470,7200,0,0,4,1470,0,1907,0
5990,10450,1,4,3,4050,1940,2002,0
2520,9324,0,0,4,1320,1200,1962,0
1440,4225,0,0,3,1440,0,2005,0
1640,7350,0,0,3,1140,500,1984,0
2150,20181,0,0,3,1090,1060,1963,2008
1570,8210,0,0,4,1150,420,1952,0
1980,10350,0,0,4,1430,550,1968,0
1210,4731,0,0,3,1210,0,1901,0
1900,3000,0,0,5,1070,830,1903,0
1940,219527,0,0,3,1940,0,1991,0
1310,8065,0,0,4,1310,0,1948,0
990,39964,0,0,2,990,0,1945,0
3870,3819,0,0,3,2760,1110,2002,0
1340,4320,0,0,3,920,420,1912,1993
2160,5600,0,0,5,1080,1080,1947,0
2080,13510,0,0,3,1040,1040,1950,2005
1300,11374,0,0,5,1300,0,1933,0
2610,8031,0,0,3,2610,0,1998,2006
1050,8498,0,0,4,1050,0,1959,0
2480,6112,0,0,3,2480,0,2004,2003
1820,8255,0,0,4,1320,500,1930,0
1170,8740,0,0,4,1170,0,1968,0
2370,6000,0,2,3,1440,930,1959,1989
3090,7415,0,0,3,3090,0,2014,0
2310,11200,0,0,4,1630,680,1978,2000
2060,10358,0,0,4,1320,740,1962,0
2540,237402,0,0,3,2540,0,2007,0
2400,7693,0,0,3,2400,0,2003,0
1320,8450,0,0,3,880,440,1961,2004
790,6600,0,0,3,790,0,1949,1998
1790,14690,0,1,4,1670,120,1960,2001
1820,7326,0,0,3,1820,0,1983,2009
1670,3000,0,0,5,900,770,1911,1984
3990,9938,0,0,3,3990,0,2001,0
1430,6000,0,0,5,1430,0,1945,0
2030,103672,0,0,4,2030,0,1969,0
1290,3060,0,0,4,1290,0,1906,1990
3820,13224,0,0,3,3280,540,1990,2009
2520,3360,0,0,4,1550,970,1931,0
3880,13000,0,0,3,3880,0,1972,2003
1590,5136,0,3,3,1320,270,1927,2011
3530,9385,0,0,3,3530,0,1925,2002
1610,4611,0,0,3,1610,0,1996,0
3280,209088,0,0,3,3280,0,1994,0
1860,15681,0,0,4,1860,0,1971,0
1840,5000,0,0,4,920,920,1910,0
2120,7201,0,0,3,2120,0,2003,0
2270,9247,0,0,5,1500,770,1972,0
2840,48716,0,3,3,1870,970,1994,0
1220,9600,0,0,3,1220,0,1980,0
2310,4079,0,0,3,2310,0,2008,0
1840,7300,0,0,3,1840,0,1966,1963
950,1110,0,0,3,950,0,2003,0
3070,8400,0,0,4,3070,0,1970,0
1730,38884,0,0,3,1730,0,1997,0
920,8341,0,0,3,920,0,1939,1969
3200,6699,0,0,3,3200,0,2004,2003
3010,15992,0,0,3,3010,0,1996,0
1600,10240,0,0,3,1090,510,1979,2014
2840,11044,0,0,3,2840,0,2001,0
2430,10500,0,1,3,2430,0,1989,0
1750,11461,0,0,4,1750,0,1976,1992
1240,949,0,0,3,1240,0,2008,0
1530,1612,0,0,3,1530,0,2006,0
3390,10078,0,0,3,3040,350,2012,1912
2320,6775,0,0,3,2320,0,2008,0
2650,6884,0,0,3,2650,0,2012,1912
2238,7209,0,0,3,2238,0,2011,0
2620,7553,0,0,3,2620,0,1996,0
1910,7280,0,0,3,1160,750,1979,2014
3040,6587,0,0,3,3040,0,2003,0
4640,15235,0,1,3,2860,1780,1965,2003
1500,4000,0,0,3,900,600,1925,2002
380,15000,0,0,3,380,0,1963,2008
2970,14486,0,0,3,2340,630,1997,0
3030,9273,0,0,5,3030,0,1988,0
1890,12236,0,0,3,1230,660,1978,0
1040,3600,0,0,4,1040,0,1919,1980
2090,10306,0,0,3,2090,0,1986,0
1680,5756,0,0,4,1680,0,1910,0
2770,7781,0,0,3,2770,0,2006,0
1020,5130,0,0,4,1020,0,1948,0
1470,4653,0,0,4,1470,0,1985,0
1430,3480,0,0,3,980,450,1947,2012
2050,10920,0,3,3,1450,600,1974,0
2080,5500,0,0,3,1040,1040,1941,1994
2870,8170,0,0,3,2250,620,1995,0
3940,27591,0,3,3,3440,500,2000,0
1520,4288,0,0,3,1020,500,1949,1998
1700,14133,0,1,4,1700,0,1954,1979
1940,11612,0,0,4,1100,840,1981,0
2870,5453,0,1,4,2220,650,1926,1993
3240,8338,0,0,3,3240,0,2001,0
1150,7156,0,0,4,1150,0,1953,1983
1440,28516,0,0,4,1440,0,1975,0
2200,4080,0,0,5,1420,780,1916,0
1470,8089,0,0,3,1470,0,1987,2000
1760,4400,0,0,4,880,880,1930,0
1780,8085,0,0,3,1210,570,1976,0
2450,21000,0,2,4,1650,800,1954,1979
1890,1710,0,0,3,1640,250,1999,0
2540,5612,0,0,3,2540,0,1999,0
1360,6000,0,0,3,1360,0,1917,2009
1310,2841,0,0,3,1310,0,2004,2003
1510,7884,0,0,3,1510,0,1942,2014
1860,60960,0,0,4,1140,720,1967,0
2200,7700,0,0,3,1100,1100,1979,2014
3360,11548,0,0,3,3360,0,1988,2000
2470,10125,0,0,3,2470,0,1960,2012
1260,3960,0,0,3,690,570,1925,2002
1430,10005,0,0,4,1430,0,1950,1983
1230,7420,0,0,5,1230,0,1913,0
2320,11717,0,0,3,2320,0,1997,0
3290,6628,0,0,3,3290,0,2003,0
2550,4770,0,0,3,2550,0,2005,0
1870,5013,0,0,3,1870,0,2003,0
3110,12429,0,0,3,1790,1320,1977,2004
1820,8085,0,0,3,1820,0,1983,2009
3050,18892,1,4,4,1650,1400,1962,0
1890,6302,0,0,3,1890,0,1997,0
800,16306,0,0,2,680,120,1931,0
6900,244716,0,0,4,4820,2080,2002,0
2670,189486,0,4,3,2670,0,1972,2002
3260,11700,0,0,3,1630,1630,1964,2000
860,6600,0,0,5,860,0,1949,0
3366,7800,0,2,3,2966,400,1937,1999
3840,4800,0,3,3,2750,1090,2008,0
3850,13551,0,2,3,3000,850,1998,2006
2040,8265,0,0,3,2040,0,1996,0
1790,10209,0,0,3,1290,500,1967,2011
3740,30884,0,0,3,3060,680,1988,2000
2660,4000,0,0,3,2170,490,2003,0
3230,17833,0,0,4,3230,0,1973,0
3140,10437,0,0,4,2040,1100,1959,0
5480,10800,0,3,4,4430,1050,1999,0
1160,3750,0,0,3,1160,0,1910,2006
1860,11227,0,0,3,1860,0,1995,0
1630,7626,0,0,5,1110,520,1990,0
1750,1879,0,0,3,1750,0,2001,0
1300,8160,0,0,4,1300,0,1960,2001
960,7314,0,0,5,960,0,1960,0
1850,7777,0,0,5,1850,0,1989,0
3260,4900,0,0,3,3260,0,2013,1923
2420,7927,0,0,4,1400,1020,1973,0
1460,10000,0,0,3,1460,0,2002,0
2240,8504,0,0,3,2240,0,1992,0
1240,27042,0,1,3,1000,240,1943,2002
2060,9552,0,0,4,1610,450,1975,0
2280,10319,0,0,3,1300,980,1959,1989
2510,6853,0,2,3,2510,0,2006,0
3150,7035,0,0,3,3150,0,2004,2003
2780,10192,0,0,4,2780,0,1978,2000
2380,4080,0,0,3,2380,0,1917,2009
2140,3000,0,0,3,2140,0,1905,2006
840,4239,0,0,3,840,0,1948,1994
2170,9665,0,0,4,1300,870,1976,1992
4410,36200,0,0,3,4410,0,1989,0
2120,11479,0,0,4,1060,1060,1940,2001
6630,13782,0,0,3,4930,1700,2004,2003
3290,22649,0,0,4,3290,0,1993,0
2290,7420,0,0,3,1290,1000,1973,2013
4910,43560,0,0,4,4000,910,1989,0
3730,8014,0,0,3,3730,0,2012,1912
2440,4800,0,0,3,2440,0,2014,0
2570,4600,0,0,3,2570,0,2014,0
2970,4400,0,0,3,2970,0,2014,0
2630,3149,0,0,3,1670,960,2013,1923
1530,1565,0,0,3,1280,250,2005,0
3690,8837,0,0,3,3690,0,2001,0
1230,1820,0,0,4,830,400,1948,0
2200,20000,0,1,3,1400,800,1952,2008
2330,8994,0,0,3,2330,0,1986,0
2160,6300,0,1,4,2160,0,1928,0
1550,9176,0,0,3,1000,550,1956,2001
1780,2788,0,0,4,890,890,1943,0
2610,5544,0,0,3,1680,930,1934,1978
3290,6830,0,0,3,3290,0,2000,0
1330,6000,0,0,4,960,370,1914,1945
3530,14406,0,1,3,2570,960,1987,2000
2090,6023,0,0,3,2090,0,1990,2009
2040,8400,0,0,3,1420,620,1963,2008
2370,10083,0,0,5,2370,0,1966,0
2810,10613,0,0,3,2810,0,1989,0
2050,40003,0,0,4,1570,480,1977,0
2870,5000,0,0,4,1840,1030,1907,0
2130,7300,0,0,4,1230,900,1963,0
2580,6260,0,0,3,2580,0,2004,2003
2380,13550,0,0,3,2380,0,1999,0
1940,25600,0,0,1,1940,0,1962,0
1610,17600,0,0,3,1610,0,1930,1983
2060,5750,0,0,3,1330,730,1976,0
1010,3000,0,0,4,1010,0,1925,1968
2810,11120,0,0,3,2810,0,1982,0
2380,11824,0,0,4,1450,930,1972,0
1060,7200,0,0,4,1060,0,1951,1999
1560,7207,0,0,3,1250,310,1983,2009
1500,8645,0,0,4,1500,0,1963,0
970,4560,0,0,4,970,0,1907,0
1170,11100,0,0,4,1170,0,1968,0
2280,7417,0,0,3,2280,0,1998,2006
2800,9569,0,2,3,1400,1400,1963,2008
1150,9360,0,0,3,1150,0,1970,2014
2180,7956,0,0,3,2180,0,1980,0
2520,7253,0,0,3,2520,0,1990,2009
1760,7482,0,0,4,1760,0,1966,0
1180,6552,0,0,4,1180,0,1949,1985
950,4625,0,0,4,950,0,1949,1985
1900,3255,0,0,3,1900,0,1988,2000
2300,6158,0,0,3,2300,0,1999,0
2660,8400,0,0,5,1550,1110,1962,0
1530,389126,0,0,4,1530,0,1919,1985
1850,5040,0,0,3,1230,620,1930,2013
4230,20377,0,0,3,4230,0,1997,0
1200,5029,0,0,3,880,320,1937,1999
2270,5102,0,0,5,1340,930,1954,0
1090,9600,0,0,4,1090,0,1968,0
1100,750,0,0,3,780,320,2008,0
1640,1269,0,0,3,1640,0,2009,0
1950,8625,0,0,3,1360,590,1959,1989
1660,10150,0,0,3,1660,0,1957,2000
880,9238,0,0,5,880,0,1946,0
1500,1375,0,0,3,1200,300,2014,0
1890,1599,0,0,3,1430,460,2012,1912
1150,5100,0,0,3,1150,0,1911,2005
2430,15264,0,0,3,2430,0,1997,0
2110,7208,0,0,3,1170,940,1975,0
2950,12196,0,0,4,2310,640,1918,1974
1650,2958,0,0,3,1650,0,1985,0
2110,11319,0,0,4,2110,0,1978,2000
2010,19000,0,0,4,2010,0,1975,0
3030,29163,0,0,3,3030,0,1998,2006
1270,8400,0,0,3,1270,0,1955,2005
1610,8613,0,0,5,1610,0,1962,0
1140,4200,0,0,4,1140,0,1904,0
2110,4118,0,0,3,2110,0,1989,0
1840,8086,0,0,4,1840,0,1964,0
1560,5223,0,0,4,810,750,1940,2001
1840,7412,0,0,4,1240,600,1976,1992
1830,7345,0,0,4,1540,290,1973,0
2120,7420,0,0,4,1060,1060,1956,0
1600,10280,0,0,3,1050,550,1977,2004
1450,8891,0,0,3,1180,270,1962,2003
1880,12821,0,0,3,1880,0,1959,1989
1270,8100,0,0,3,880,390,1950,2005
1720,6417,0,0,3,1720,0,1953,0
2400,7351,0,0,3,2400,0,1990,2009
1150,8145,0,0,4,990,160,1932,1958
870,11100,0,0,3,870,0,1940,1996
2000,37045,0,0,3,2000,0,1989,0
2420,38781,0,0,5,1210,1210,1949,0
1080,6000,0,0,4,1080,0,1952,0
3420,30410,0,0,3,3420,0,1988,2000
1870,7471,0,0,3,1870,0,1990,2009
2500,206474,0,0,3,2500,0,1997,0
2150,8221,0,0,3,2150,0,1992,0
1470,2500,0,0,3,1080,390,1984,0
2130,4180,0,0,5,1270,860,1926,0
1000,19204,0,0,3,1000,0,1968,2010
2390,7149,0,0,3,1350,1040,1955,2005
860,2599,0,0,4,860,0,1901,0
1960,12476,0,0,4,1960,0,1989,0
2000,6107,0,0,3,2000,0,2003,0
1620,9450,0,0,3,1620,0,1928,1954
2890,8122,0,0,3,1630,1260,1977,2004
1300,12731,0,0,3,1300,0,1981,2013
1080,3500,0,3,3,1080,0,1924,2011
2170,8518,0,3,3,1350,820,1955,2005
2260,10153,0,0,3,2260,0,1987,2000
1580,8820,0,0,4,1580,0,1967,0
2620,4469,0,0,3,2620,0,2008,0
1540,1860,0,0,3,1540,0,2014,0
4570,74487,0,4,5,4570,0,1948,1985
3440,7661,0,0,3,3440,0,2006,0
1740,8750,0,0,4,1740,0,1959,0
2160,4333,0,0,4,1260,900,1942,1982
1480,6978,0,0,4,1480,0,1949,1985
2260,280962,0,2,3,1890,370,2005,0
3910,59863,0,0,4,2490,1420,1987,0
1700,20283,0,0,3,1340,360,1965,1993
4470,35124,0,0,3,4470,0,1984,0
1800,6000,0,0,5,900,900,1905,0
1630,1677,0,0,3,1630,0,2007,0
1030,9834,0,0,3,1030,0,1969,2010
720,5100,0,0,3,720,0,1907,1983
1890,43560,0,0,4,1890,0,1974,0
1840,5550,0,0,3,1840,0,2004,2003
2540,8400,0,0,5,2540,0,1977,0
3520,3944,0,0,5,2200,1320,1913,0
3220,7875,0,0,4,3220,0,1966,0
1820,5000,0,0,4,1720,100,1941,1998
1230,9600,0,0,4,1230,0,1984,0
1340,8505,0,0,3,1340,0,1931,0
1200,13100,0,0,3,1200,0,1943,2002
1390,18200,0,0,4,1390,0,1962,0
1730,3884,0,0,5,1060,670,1924,1956
1580,39189,0,0,3,1180,400,1992,0
3520,4895,0,0,3,1980,1540,1954,2005
2650,30500,0,0,4,1680,970,1960,2001
1310,12750,0,0,3,1310,0,1993,0
2300,7989,0,0,3,2300,0,1990,2009
1780,7280,0,2,3,1340,440,1972,2002
1980,2850,0,0,3,1980,0,1987,2000
1300,1676,0,2,3,1300,0,1943,2002
3500,10155,0,0,3,2570,930,1996,0
1830,8004,0,0,3,1200,630,1960,2012
1520,1245,0,0,3,1520,0,2004,2003
2700,37011,0,0,3,2700,0,1984,0
2810,18731,1,4,4,2810,0,1974,0
1660,6263,0,0,3,1660,0,2003,0
1310,6738,0,0,4,1310,0,1990,0
2960,6000,0,0,3,2960,0,2014,0
2242,4995,0,0,3,2242,0,2011,0
2540,4775,0,0,3,2540,0,2006,0
1420,1192,0,0,3,1140,280,2008,0
1270,2356,0,0,3,1270,0,2012,1912
1300,907,0,0,3,1000,300,2006,0
3190,7081,0,2,3,1890,1300,2013,1923
2910,5027,0,0,3,2040,870,2013,1923
1630,3817,0,0,3,1630,0,2005,0
2300,8214,0,0,3,2300,0,2013,1923
3310,5300,0,2,3,2440,870,2008,0
940,1768,0,0,3,940,0,2009,0
1020,1350,0,0,3,1020,0,2009,0
1520,6380,0,0,3,790,730,1948,1994
2330,5000,0,0,4,1510,820,1929,0
1010,9600,0,0,4,1010,0,1962,0
1070,8000,0,0,3,1070,0,1977,2004
3170,12750,0,0,3,2360,810,1995,0
3030,3841,0,0,3,3030,0,2005,0
2270,100545,0,0,3,2270,0,1998,2006
2341,9594,0,0,3,2341,0,1997,0
2130,6150,0,2,5,1530,600,1908,0
2300,35722,0,0,3,2300,0,1984,0
1660,11783,0,0,4,1160,500,1978,2000
2610,8760,0,0,4,1760,850,1978,2000
2150,7007,0,0,3,2150,0,1954,2005
2410,64073,0,0,4,1820,590,1976,1992
1580,3680,0,2,3,1280,300,1941,1994
1740,30886,0,0,3,1740,0,1992,0
1270,5000,0,0,3,1090,180,1949,1998
2550,6000,0,0,5,1860,690,1902,0
1860,15559,0,0,4,1860,0,1963,0
2700,27072,0,0,3,1380,1320,1958,2004
1460,8710,0,0,3,1460,0,1955,2005
1330,13102,0,0,3,1330,0,1968,1997
2070,4132,0,0,3,2070,0,1999,0
1360,10726,0,0,4,1360,0,1966,0
2650,18295,0,0,3,2650,0,1986,0
3580,35261,0,0,3,3580,0,1985,0
2034,13392,1,4,5,1159,875,1947,0
1230,11413,0,0,3,990,240,1984,0
2450,55387,0,0,3,2450,0,1994,0
2840,8346,0,0,5,1420,1420,1961,0
3820,53574,0,0,3,3820,0,1994,0
2740,5925,0,2,3,2740,0,1913,1992
2090,5289,0,0,3,2090,0,1989,0
6390,13180,0,0,3,4560,1830,1940,1996
2470,5080,0,0,3,1970,500,1948,1988
1720,4080,0,0,4,960,760,1924,0
3090,9571,0,0,3,2370,720,2004,2003
2320,3825,0,0,5,1820,500,1926,0
1740,7700,0,0,5,1740,0,1968,0
2950,4502,0,0,3,2950,0,2005,0
4810,28008,0,0,3,4810,0,1990,2009
1500,5412,0,0,5,900,600,1920,0
1810,100188,0,0,5,1810,0,1969,0
1100,4128,0,0,4,720,380,1942,1982
1490,7435,0,0,3,1120,370,1969,2010
1200,1259,0,0,3,1000,200,2013,1923
1890,8505,0,0,3,1290,600,1980,0
2200,9840,0,0,5,1500,700,1978,0
2510,7992,0,0,3,1610,900,1978,0
1420,1309,0,0,3,1420,0,2006,0
2000,9900,0,2,4,1480,520,1957,2001
1460,9052,0,2,5,1460,0,1900,0
3220,22588,0,0,3,3220,0,1996,0
1310,8454,0,0,4,1310,0,1953,1983
690,5280,0,0,4,690,0,1942,1982
1150,10466,0,0,5,1150,0,1959,0
1480,7284,0,0,3,970,510,1963,2008
1850,6000,0,0,4,1270,580,1944,0
1930,4500,0,0,3,1930,0,1990,2009
750,5120,0,0,4,750,0,1941,1998
1430,2003,0,0,3,980,450,1996,0
1840,11440,0,0,4,1340,500,1977,0
1300,14350,0,0,3,1300,0,1955,2013
1050,7577,0,0,3,1050,0,1983,2009
2210,9371,0,0,4,2210,0,1968,0
3220,15600,0,0,5,1680,1540,1973,0
4620,20793,0,0,4,4620,0,1991,0
1760,6204,0,2,4,1180,580,1950,1983
850,6906,0,0,3,850,0,1948,1994
4690,14930,0,2,3,3680,1010,1995,0
3920,37122,0,0,3,3920,0,1996,0
2140,3821,0,0,3,2140,0,2005,0
1180,9265,0,0,3,1180,0,1940,1996
2360,11375,0,0,4,1180,1180,1962,0
3060,9950,0,2,4,1810,1250,1930,0
1670,7881,0,0,4,1190,480,1977,0
1820,5756,0,0,3,1640,180,1946,0
1970,9607,0,0,3,1090,880,1988,2000
930,747,0,0,3,630,300,2007,0
2300,5611,0,0,3,2300,0,2004,2003
2590,18980,0,0,4,2590,0,1976,1992
1450,8450,0,0,3,1450,0,1960,2012
1540,5120,0,0,5,770,770,1943,0
2730,22572,0,0,3,2080,650,1968,1992
880,18205,0,0,4,880,0,1945,0
3190,8195,0,0,3,3190,0,2006,0
1330,7600,0,0,4,1330,0,1968,0
1500,7200,0,0,3,1500,0,1957,2000
740,7680,0,0,4,740,0,1922,0
2560,5606,0,0,3,2560,0,2004,2003
2540,4750,0,0,5,1840,700,1930,0
3200,203425,0,0,3,3200,0,2000,0
3330,4000,0,0,3,1790,1540,1958,2004
900,5220,0,0,4,900,0,1956,0
1600,6180,0,0,3,1600,0,1946,0
970,5500,0,0,3,970,0,1956,2001
1130,2640,0,0,4,1130,0,1927,0
650,5400,0,0,3,650,0,1950,2005
2400,5000,0,0,4,1440,960,1926,1993
2280,6031,0,0,3,2280,0,2011,0
3550,13900,0,0,3,1830,1720,2010,0
2050,2772,0,0,3,2050,0,2012,1912
830,1119,0,0,3,830,0,2005,0
2440,4850,0,0,3,2440,0,2013,1923
1600,1936,0,0,3,1600,0,2007,0
3190,31450,0,0,3,3190,0,2010,0
2550,4000,0,0,3,2370,180,1905,2010
2180,7508,0,0,4,1420,760,1962,0
1410,9600,0,0,4,1410,0,1983,0
1410,5760,0,0,3,1410,0,1985,0
2340,8548,0,0,3,2340,0,1993,0
1320,9000,0,0,3,1320,0,1966,1963
3990,13470,0,0,3,3990,0,2006,0
1270,7566,0,0,4,1270,0,1958,1972
4380,47044,1,3,3,3720,660,1968,1990
4250,8570,0,0,3,4250,0,2004,2003
1860,8060,0,0,4,1860,0,1987,0
3770,37034,0,0,3,2830,940,1989,0
1530,8890,0,0,3,980,550,1925,2002
3570,8250,0,0,3,2860,710,2013,1923
1740,5719,0,0,3,1740,0,1955,2005
1670,8364,0,0,4,1300,370,1990,0
1570,9415,0,0,4,1570,0,1984,0
1590,1845,0,0,3,1590,0,1997,0
2980,5377,0,0,3,2980,0,2006,0
2690,4736,0,0,3,2690,0,2001,0
900,2910,0,0,5,900,0,1924,1956
1440,3700,0,0,3,1200,240,1914,1996
3000,10392,0,0,3,3000,0,1995,0
1640,18144,0,0,3,1640,0,1942,1999
3100,10200,0,4,3,1660,1440,1970,2014
4000,15253,0,0,3,4000,0,2007,0
2020,48693,0,0,3,2020,0,1949,1998
1840,5000,0,0,5,1340,500,1915,0
2100,9984,0,0,4,1290,810,1973,0
2460,11250,0,0,4,2460,0,1959,0
2610,7510,0,0,3,2610,0,1996,0
1460,6377,0,0,3,1460,0,1995,0
1050,8498,0,0,3,1050,0,1958,2004
1790,8144,0,0,3,1790,0,1989,0
2180,3375,0,0,4,1420,760,1926,1993
2050,9583,0,2,3,1770,280,1965,1993
2790,19439,0,3,5,1500,1290,1973,0
1700,3333,0,0,3,1100,600,1924,2011
2380,6832,0,0,3,2380,0,2002,0
2000,4211,0,2,4,1280,720,1908,0
1670,4008,0,0,3,1670,0,2005,0
1190,4750,0,0,3,970,220,1940,1996
3040,28535,0,0,3,1890,1150,1951,1994
780,3475,0,0,4,780,0,1930,0
2330,11740,0,0,3,1330,1000,1954,2005
2840,4000,0,0,5,1960,880,1912,0
2490,5170,0,0,4,2490,0,2000,0
770,4840,0,0,4,770,0,1927,0
1850,16960,0,2,4,1850,0,1953,1983
1090,3264,0,0,4,1090,0,1969,0
1780,5336,0,0,5,930,850,1918,0
930,29258,0,0,3,930,0,1941,1994
2770,5686,0,0,3,2770,0,2004,2003
1250,6180,0,0,3,1250,0,1955,2005
1830,6136,0,0,3,1830,0,1990,2009
870,5400,0,0,3,870,0,1950,2007
1150,8450,0,0,4,1150,0,1951,1999
4500,9648,0,4,4,3000,1500,1968,0
1150,4800,0,0,4,1150,0,1938,0
2000,3672,0,0,5,1650,350,1926,0
1900,8240,0,0,2,1200,700,1964,0
1640,10695,0,2,3,1640,0,1975,0
2680,4775,0,2,5,1880,800,1913,0
2420,7307,0,0,3,2420,0,1998,2006
1790,7650,0,3,3,1790,0,1978,0
3920,12415,0,0,3,3920,0,1997,0
1640,8400,0,0,3,1180,460,1968,1997
890,8400,0,0,4,890,0,1954,1979
1910,16532,0,0,4,1420,490,1940,2001
2140,7910,0,0,3,1070,1070,1962,2003
2030,17100,0,0,4,2030,0,1953,1983
4225,284011,0,0,4,4225,0,1985,0
2680,9162,0,0,3,1570,1110,1978,0
2030,3974,0,0,3,2030,0,1994,0
5850,22885,0,2,4,4670,1180,1978,2000
2060,8398,0,0,3,1260,800,1962,2003
1060,3036,0,0,4,1060,0,1943,0
1010,8184,0,0,4,1010,0,1947,1988
3310,127631,0,0,5,3310,0,1924,1956
2000,10051,0,0,3,2000,0,1997,0
3070,8086,0,0,3,3070,0,2005,0
1270,1406,0,0,3,1060,210,2014,0
3110,49765,0,0,4,3110,0,1958,1972
2110,18815,0,0,5,2110,0,1979,0
1400,11400,0,0,3,1400,0,1984,0
2310,5650,0,2,3,1330,980,1952,2012
2700,16570,0,0,4,1750,950,1967,0
2370,15512,0,0,4,2370,0,1981,0
2760,6000,0,0,5,2230,530,1942,0
1610,6300,0,0,3,1010,600,1941,1994
1230,8250,0,0,3,1230,0,1966,1963
1900,11165,0,0,4,1900,0,1959,0
1580,8184,0,0,3,1140,440,1954,2005
1940,2885,0,2,3,1940,0,1900,2005
1620,6000,0,0,5,1040,580,1947,0
1940,5458,0,0,3,1940,0,1994,0
1230,8750,0,0,3,1230,0,1965,1993
3160,5000,0,2,3,2180,980,2005,0
2700,21208,0,0,4,1950,750,1955,2009
1880,6200,0,2,5,1440,440,1954,0
890,8100,0,0,3,890,0,1942,1999
1720,3676,0,0,3,1720,0,1992,0
1620,7686,0,0,3,1620,0,1989,0
1380,4390,0,0,4,880,500,1931,0
1870,9000,0,0,5,1870,0,1958,0
1970,22144,0,0,4,1970,0,1970,0
1110,8593,0,0,3,1110,0,1979,2014
1190,6833,0,0,3,1190,0,1995,0
1150,11802,0,0,4,1150,0,1932,1958
2890,6825,0,0,3,1560,1330,1973,2013
1500,13430,0,0,3,1500,0,1977,2004
1950,2617,0,0,4,1250,700,1910,0
1250,7700,0,0,5,1250,0,1968,0
2070,5415,0,0,3,2070,0,1996,0
4660,17398,0,2,3,4660,0,2003,0
1350,1493,0,0,3,1050,300,2007,0
1800,2790,0,0,3,1800,0,2011,0
1481,2820,0,0,3,1481,0,2012,1912
1730,3600,0,0,3,1730,0,2014,0
2720,4613,0,0,3,2720,0,2005,0
2320,2267,0,0,3,2320,0,2009,0
1860,3730,0,0,3,1860,0,2012,1912
2025,7760,0,0,3,2025,0,2007,0
1400,1312,0,0,3,1400,0,2007,0
2620,5477,0,0,3,2620,0,2009,0
2450,2691,0,0,3,1750,700,1915,0
1590,1102,0,0,3,1590,0,2010,0
2085,174240,0,0,3,1610,475,1964,2000
3450,7832,0,0,3,3450,0,2007,0
1780,16290,0,0,4,1780,0,1987,0
3060,7140,0,0,3,3060,0,2006,0
1700,11475,0,0,5,970,730,1945,0
1330,5926,0,0,4,1330,0,1942,1982
3060,5000,0,0,3,3060,0,2001,0
1220,6000,0,0,3,1220,0,1968,1997
1600,9289,0,0,4,1600,0,1959,0
1530,17664,0,0,3,1530,0,1968,1997
1980,13964,0,0,5,1980,0,1959,0
1730,8490,0,0,3,1210,520,1969,2010
1170,6700,0,0,3,1170,0,1957,2000
1950,10766,0,3,4,1160,790,1952,0
1470,20000,0,0,4,1470,0,1968,0
1400,8840,0,0,4,1400,0,1952,0
4040,50479,0,0,3,4040,0,1987,2000
3110,5000,0,0,5,1810,1300,1921,0
1490,4400,0,0,4,1490,0,1906,1990
1770,5750,0,0,3,1770,0,1947,2012
3320,19850,0,2,4,2040,1280,1977,0
950,5316,0,2,3,950,0,1948,1994
2430,5499,0,0,3,2430,0,2002,0
2660,10800,0,0,3,2660,0,1955,2014
2670,11877,0,0,3,2670,0,1996,0
2720,7598,0,0,3,1860,860,1993,0
3200,22651,0,0,5,1610,1590,1970,0
2480,37843,1,3,4,2480,0,1974,0
1780,10395,0,0,3,1780,0,1967,2011
1590,11276,0,0,4,1590,0,1972,0
1550,34175,0,0,3,1550,0,1999,0
2850,14800,0,0,4,1920,930,1976,1992
2600,5875,0,2,5,1600,1000,1929,0
1230,7410,0,0,3,1230,0,1944,0
2080,16117,0,0,5,1740,340,1959,0
3600,6875,0,0,3,2740,860,2004,2003
2110,8751,0,0,3,1510,600,1962,2003
2550,19017,0,0,4,1300,1250,1961,2001
1650,6684,0,0,3,1650,0,1991,0
1370,1221,0,0,3,1080,290,2008,0
1010,7200,0,0,3,1010,0,1975,0
2330,26571,0,0,3,2330,0,1987,2000
620,2475,0,0,5,620,0,1911,1984
2450,12497,0,0,4,2450,0,1967,0
2530,7350,0,0,5,1280,1250,1977,0
2220,4652,0,0,3,2220,0,2001,0
2110,265716,0,0,4,2110,0,1979,0
3690,49709,0,2,3,2690,1000,1960,2012
1940,10200,0,0,4,1140,800,1977,0
2070,7350,0,0,4,2070,0,1977,0
2160,7826,0,0,4,1390,770,1976,1992
2600,9900,0,0,3,1600,1000,1965,1993
2880,4000,0,0,3,2100,780,1912,2000
2260,7200,0,0,4,2260,0,1984,0
3640,6930,0,0,3,3640,0,2004,2003
1530,23660,0,0,3,1530,0,1952,2008
2490,4000,0,0,5,1670,820,1918,0
1440,11787,0,0,3,1440,0,1983,2009
3760,8500,0,3,4,3060,700,1910,0
1720,6975,0,0,3,1420,300,1975,0
2480,16360,0,0,5,1510,970,1959,0
3990,5267,0,0,3,3990,0,2008,0
840,3340,0,0,3,700,140,1912,1994
2270,11989,0,0,4,2270,0,1968,0
2580,5476,0,0,3,2580,0,2005,0
1580,6620,0,0,3,1580,0,1988,2000
950,7954,0,0,4,950,0,1941,1998
3190,5040,0,3,3,2160,1030,2003,0
3740,136915,0,0,3,3100,640,1990,2009
2620,4743,0,2,4,1310,1310,1949,1985
2080,75794,0,0,3,2080,0,1958,2004
1660,3729,0,0,5,970,690,1922,1956
1520,11085,0,0,3,1520,0,1983,2009
1140,27760,0,0,4,1140,0,1981,0
3240,8016,0,0,3,2910,330,2004,2003
2460,41343,0,0,4,2460,0,1988,0
1750,5080,0,0,3,1750,0,1903,2005
2430,5000,0,0,4,1760,670,1945,0
1060,9946,0,0,4,1060,0,1956,0
2410,7479,0,2,3,2410,0,1942,1988
720,8040,0,0,3,720,0,1943,2002
1260,9346,0,0,4,1260,0,1963,0
1640,12384,0,0,4,1090,550,1954,1979
1310,9612,0,0,3,960,350,1962,2003
2120,6290,0,0,4,1220,900,1949,1985
3320,478288,0,3,4,2260,1060,1933,1982
1210,9622,0,1,3,1210,0,1955,2009
2590,12063,0,0,3,2590,0,1993,0
2250,7526,0,0,3,2250,0,1989,0
4040,20001,0,0,3,2020,2020,1972,2001
1090,6710,0,0,5,1090,0,1912,0
1660,15600,0,0,3,1660,0,1981,2013
1780,81021,0,3,4,1780,0,1954,1979
3370,5000,0,2,3,2470,900,2008,0
4480,5000,0,0,5,3420,1060,1902,0
2990,16809,0,0,3,2990,0,1990,2009
2280,19000,0,0,3,2280,0,1924,2011
2480,5500,0,3,3,1730,750,1950,2005
2830,8925,0,0,3,2830,0,1967,2011
920,7569,0,0,4,920,0,1950,1983
3250,16684,0,0,3,3250,0,1979,2014
1240,6417,0,0,5,1240,0,1924,1956
3230,12100,0,0,3,1870,1360,1977,2004
2500,9583,0,0,3,1300,1200,1979,2014
1390,4482,0,0,4,1390,0,1980,0
1940,6654,0,0,4,1940,0,1953,1983
1900,8002,0,0,3,1900,0,1991,0
2380,14500,0,0,4,1850,530,1961,2001
1480,3876,0,0,5,860,620,1928,1970
3460,6738,0,0,3,3460,0,2013,1923
1444,249126,0,0,3,1444,0,2008,0
1930,3031,0,0,3,1200,730,2006,0
1200,2171,0,0,3,1200,0,1933,0
1769,7324,0,0,3,1769,0,2012,1912
2490,4540,0,0,3,2490,0,2012,1912
3060,3898,0,0,3,2300,760,2014,0
3030,6625,0,0,3,3030,0,2011,0
2370,5353,0,0,3,2370,0,2009,0
1370,913,0,0,3,1100,270,2006,0
1500,11968,0,0,3,1500,0,2014,0
1715,6819,0,0,3,1715,0,1995,0
1110,3200,0,0,3,1110,0,1925,2002
2400,8050,0,0,3,2400,0,1998,2006
1520,213444,0,3,5,1520,0,1988,0
3190,10970,0,0,3,3190,0,1994,0
2400,5300,0,0,4,1250,1150,1939,1989
1060,7473,0,0,3,1060,0,1959,1989
1220,15600,0,0,3,1220,0,1972,2002
2020,8424,0,0,4,1380,640,1979,0
2300,7700,0,0,3,1380,920,1959,1989
2300,37533,0,3,5,1550,750,1979,0
1660,1545,0,2,3,1400,260,2002,0
3900,9750,0,4,5,2520,1380,1972,0
1650,12349,0,0,3,1650,0,1957,2000
2110,35091,0,0,4,1290,820,1985,0
1960,6380,0,0,4,980,980,1939,1989
2770,63118,0,0,3,2770,0,1997,0
2440,7350,0,0,3,1610,830,1978,0
1320,8380,0,0,3,1320,0,1953,0
2570,4865,0,0,3,2570,0,2005,0
940,5040,0,0,3,940,0,1926,2003
700,4800,0,0,3,700,0,1922,2008
1400,45738,0,0,4,1400,0,1981,0
1890,7867,0,0,3,1890,0,1996,0
720,11400,0,0,5,720,0,1951,0
2410,8944,0,0,4,1860,550,1967,0
1630,7950,0,0,3,1320,310,1985,0
2330,14322,0,0,4,1180,1150,1968,0
1330,10838,0,0,3,1330,0,1985,0
3190,11597,0,0,3,2300,890,1984,0
1400,6300,0,0,3,1400,0,1998,2006
970,9583,0,0,4,970,0,1967,0
1010,9600,0,0,5,1010,0,1969,0
3580,54450,0,0,3,3580,0,1990,2009
1050,2570,0,0,5,850,200,1927,0
2500,7200,0,0,4,1490,1010,1977,0
2630,4896,0,0,3,2630,0,2006,0
6640,53330,0,0,3,6640,0,1993,0
910,8789,0,0,3,910,0,1966,1963
2610,35000,0,0,3,2610,0,1988,2000
1720,6194,0,0,3,1720,0,1998,2006
3650,13297,0,0,5,2750,900,1969,0
2040,22693,0,0,4,2040,0,1980,0
3260,24300,0,1,4,2310,950,1950,1983
1590,8911,0,0,3,1590,0,1956,2001
1440,7100,0,0,3,1440,0,1906,2014
900,3400,0,0,5,900,0,1905,0
3120,4240,0,2,4,2090,1030,1993,0
1060,1536,0,0,3,1060,0,2000,0
3000,9793,0,0,3,3000,0,2002,0
2230,5348,0,0,3,2230,0,2000,0
1890,5000,0,0,3,1090,800,1906,2014
4150,16197,0,0,3,4150,0,2006,0
1780,10409,0,0,3,1280,500,1981,2013
2710,6583,0,0,3,2710,0,2003,0
4390,13833,0,3,3,3320,1070,2003,0
1640,4080,0,0,5,1540,100,1916,0
1670,4800,0,3,3,1670,0,1903,2005
2570,10431,0,0,3,2570,0,1989,0
1500,3420,0,0,3,1500,0,1902,0
2710,19000,0,3,4,2710,0,1950,1983
2860,48351,0,0,3,1710,1150,1978,0
840,40642,1,4,4,840,0,1937,0
2990,8913,0,0,4,2990,0,1991,0
1170,6757,0,0,4,800,370,1944,0
1200,6240,0,0,3,1030,170,1952,2008
1020,8100,0,0,3,1020,0,1940,1996
910,8155,0,0,4,910,0,1948,0
700,2500,0,0,4,700,0,1907,0
2420,37800,0,0,4,1880,540,1981,0
1950,8712,0,0,3,1950,0,1960,2012
3060,6000,0,0,3,3060,0,2012,1912
1390,18000,0,0,3,1390,0,1955,2013
1200,1687,0,0,3,1200,0,2008,0
2440,4153,0,0,3,2440,0,2003,0
2310,3075,0,0,3,1730,580,2005,0
2600,64626,0,0,3,2600,0,2009,0
1490,1212,0,0,3,1040,450,2011,0
2432,9391,0,2,3,2432,0,2005,0
3610,8580,0,0,3,3610,0,2014,0
2530,10000,0,0,3,2530,0,2013,1923
2790,5527,0,0,3,2790,0,2014,0
1670,4440,0,0,3,1670,0,2014,0
1170,1456,0,0,3,1070,100,2007,0
1350,942,0,0,3,1350,0,2008,0
1110,1773,0,0,3,1110,0,2014,0
1100,638,0,0,3,1100,0,2014,0
2820,7200,0,0,4,2460,360,1930,0
1040,8128,0,0,3,1040,0,1983,2009
1910,3376,0,0,3,1910,0,1980,0
1370,8499,0,0,3,1370,0,1949,1998
1500,5000,0,0,4,1140,360,1927,0
1200,9087,0,0,5,1200,0,1969,0
1050,2542,0,0,3,880,170,1904,0
2670,16777,0,0,4,1620,1050,1920,0
2190,11500,0,0,4,1430,760,1972,0
3130,40918,0,0,3,3130,0,1994,0
1700,9100,0,0,3,1160,540,1998,2006
1700,17355,0,0,3,1200,500,1978,0
1360,1275,0,0,3,1240,120,2007,0
1610,15005,0,0,4,1610,0,1986,0
2130,6222,0,0,3,1300,830,1991,0
1800,7650,0,0,5,1800,0,1957,0
2950,15540,0,0,4,2120,830,1974,0
2120,54014,0,0,4,2120,0,1964,0
3500,7048,0,0,3,3500,0,2005,0
1440,9220,0,0,3,1440,0,1965,1993
2120,3360,0,0,3,2120,0,1905,2010
1780,2067,0,0,5,1780,0,1974,0
960,8153,0,0,3,960,0,1947,2012
1510,4980,0,0,3,1510,0,2006,0
1010,5750,0,0,3,1010,0,1911,1948
3790,5001,0,0,3,2810,980,1989,0
3600,8666,0,0,4,2400,1200,1948,0
1300,7030,0,0,3,1300,0,1968,1997
2500,4046,0,0,4,1520,980,1940,2001
2090,10733,0,0,3,1440,650,1958,2004
2200,14630,0,1,3,2200,0,1948,2003
2070,15002,0,0,3,2070,0,1955,2013
1320,7341,0,0,3,1320,0,1982,0
1360,60548,0,0,3,960,400,1960,2012
930,7623,0,0,2,930,0,1942,0
1760,8584,0,0,5,1760,0,1937,0
1410,8100,0,0,3,1410,0,1985,0
2570,7859,0,0,3,2570,0,1992,0
1300,14197,0,0,3,860,440,1996,0
1580,6300,0,0,3,1180,400,1925,2002
2960,6031,0,0,3,2960,0,2005,0
2330,3497,0,0,3,1920,410,2003,0
2070,39446,0,0,3,1470,600,1977,2004
970,5750,0,0,4,970,0,1932,1958
2310,7200,0,0,3,2310,0,1990,2009
2290,11173,0,0,4,2290,0,1988,0
1720,9600,0,0,4,1220,500,1967,0
1190,3400,0,0,3,990,200,1919,2001
870,5750,0,0,4,870,0,1947,1988
1068,1758,0,0,3,1068,0,1990,2009
2140,10316,0,0,3,2140,0,1993,0
3300,165528,0,0,3,3300,0,1984,0
4830,8050,0,2,4,3710,1120,1914,1945
2820,6589,0,0,3,2320,500,1906,2014
2440,9664,0,0,3,1890,550,1981,2013
1800,3245,0,0,4,1800,0,1929,0
1010,8800,0,0,4,1010,0,1954,1979
3220,4392,0,0,4,2320,900,1931,0
5000,26540,0,3,3,3410,1590,2008,0
1200,24792,0,0,2,1200,0,1976,0
1470,4322,0,0,3,1470,0,1985,0
2600,4506,0,0,3,2600,0,2003,0
2750,128502,0,0,2,1500,1250,1958,0
1320,9967,0,0,3,940,380,1919,2001
3350,4007,0,0,3,2550,800,2005,0
2650,2387,0,0,3,1830,820,1920,1979
1860,10856,0,0,3,1260,600,1952,2008
960,8855,0,0,4,960,0,1958,1972
2010,6300,0,2,5,1610,400,1937,0
900,28800,0,0,1,900,0,1928,0
2340,11784,0,0,3,2340,0,1997,0
3720,15048,0,0,3,3720,0,1979,2014
1890,29185,0,0,3,1470,420,1949,2013
2680,12215,1,4,3,1590,1090,1956,2001
1460,1613,0,0,3,1180,280,2007,0
3180,7904,0,0,3,1810,1370,2006,0
1980,15086,0,0,3,1980,0,1981,2013
1090,934,0,0,3,1090,0,2008,0
2230,5970,0,0,4,2230,0,2002,0
3330,9143,0,0,4,3330,0,1995,0
1880,3840,0,0,3,970,910,1904,0
2870,5700,0,0,3,1950,920,1964,2000
2120,9786,0,0,3,1640,480,1967,2011
2700,6998,0,0,3,2700,0,2001,0
3670,7680,0,0,3,3670,0,2007,0
1220,1330,0,0,3,1010,210,2008,0
4390,11250,0,0,3,4390,0,2007,0
3560,5265,0,0,3,3560,0,2014,0
3530,8589,0,0,3,3530,0,2007,0
2280,5000,0,0,3,2280,0,2006,0
4350,7965,0,0,3,4350,0,2013,1923
3830,221284,0,0,3,3530,300,1993,0
2050,13303,0,0,3,2050,0,1993,0
3660,39478,0,2,4,3260,400,1989,0
3350,46748,0,0,3,3350,0,2004,2003
1270,3600,0,0,3,1270,0,1963,2008
3400,3850,0,0,3,2790,610,2008,0
1200,8514,0,0,3,1200,0,1959,1989
2200,11000,0,2,3,2200,0,1978,0
1680,11312,0,0,3,1080,600,1959,1989
3840,8279,0,0,3,3840,0,2001,0
950,4500,0,2,3,850,100,1926,2003
2280,42077,0,0,3,2280,0,1994,0
1970,6600,0,0,3,1970,0,1987,2000
1620,9310,0,0,4,1620,0,1967,0
2600,7200,0,0,3,2600,0,1962,2002
1250,3825,0,0,3,850,400,1929,0
2130,5080,0,0,3,2130,0,1914,1993
2550,8976,0,0,5,1300,1250,1978,0
1150,6000,0,0,3,1150,0,1927,2011
1040,9000,0,0,4,1040,0,1967,0
3340,10422,0,0,3,3340,0,1996,0
2630,9420,0,0,5,2510,120,1900,0
1640,3896,0,0,3,1640,0,1994,0
770,7906,0,0,4,770,0,1948,0
4350,112750,0,0,3,2200,2150,2006,0
1700,5846,0,0,3,1700,0,1957,2000
2050,9580,0,0,3,1400,650,1984,0
1660,5128,0,0,3,1660,0,2001,0
1990,9594,0,0,3,1190,800,1977,2004
7050,42840,0,2,4,4320,2730,1978,2000
1770,7000,0,0,3,1770,0,1986,0
2440,47916,0,0,3,2090,350,1991,0
2620,51354,0,0,3,2620,0,1998,2006
2440,11005,0,0,3,2440,0,1994,0
1080,7775,0,0,3,1080,0,1955,2005
1090,10710,0,0,4,1090,0,1962,0
1400,13775,0,0,3,1400,0,1963,2008
2010,7200,0,0,3,2010,0,1994,0
1640,12855,0,0,5,1500,140,1920,0
3290,5029,0,0,3,3290,0,2004,2003
2510,14878,0,0,3,2510,0,1990,2009
860,6050,0,0,3,860,0,1952,2008
2840,12866,0,0,4,1780,1060,1977,0
1750,7020,0,0,3,1750,0,1934,1978
1300,19163,0,0,3,1300,0,1964,2000
3890,7216,0,1,3,3260,630,1967,2010
1460,941,0,0,3,1460,0,2006,0
1410,3376,0,0,5,1410,0,1911,1984
3770,10900,0,2,5,3070,700,1924,1956
1190,4072,0,0,5,1190,0,1907,0
1410,6413,0,0,4,910,500,1947,1988
2500,4080,0,0,5,1680,820,1922,1956
800,2280,0,0,5,800,0,1946,0
2530,13446,0,0,3,2530,0,1993,0
2570,28500,0,0,3,1970,600,1983,2009
2090,9620,0,0,3,1340,750,1987,2000
2980,7781,0,0,3,1580,1400,1960,2012
1170,8239,0,0,3,1170,0,1981,2013
2080,5100,0,0,3,2080,0,2004,2003
3350,4000,0,0,4,2510,840,1997,0
1050,1029,0,0,3,950,100,2007,0
900,13531,0,0,3,900,0,1979,2014
1050,5000,0,0,5,1050,0,1907,0
3740,32481,0,0,3,2240,1500,1958,2004
1430,4096,0,0,3,1430,0,1900,2005
1400,9546,0,0,4,1400,0,1984,0
1600,45613,0,0,4,1600,0,1983,0
2880,9750,0,0,3,2880,0,1989,0
3140,5445,0,3,4,2240,900,1913,0
820,4320,0,0,3,820,0,1937,1999
5190,12637,0,2,3,5190,0,2001,0
2180,10140,0,0,4,1180,1000,1968,0
910,2002,0,0,3,910,0,1900,2005
1580,8475,0,2,4,1580,0,1928,0
2130,6325,0,0,5,1440,690,1948,1985
4570,16015,0,2,3,4570,0,1990,2009
1240,11172,0,0,3,1000,240,1984,0
1860,6000,0,2,4,1860,0,1959,0
370,1801,0,0,5,370,0,1923,0
3130,12087,0,0,3,2180,950,1975,0
2530,35150,0,0,4,1800,730,1977,0
3970,9778,0,2,4,3390,580,1928,0
1920,9680,0,0,4,1300,620,1961,2001
2970,12750,0,1,4,2130,840,1918,1986
2300,6087,0,0,3,2300,0,2001,0
1830,9601,0,0,3,1830,0,2003,0
1550,5053,0,0,4,1180,370,1963,0
4080,10666,0,0,3,4080,0,2005,0
1710,21485,0,0,3,1710,0,1989,0
2375,4094,0,0,3,2375,0,2002,0
2200,9778,0,0,4,1100,1100,1962,0
3530,17450,1,3,3,1840,1690,1930,1993
1110,9012,0,0,4,1110,0,1966,0
1630,2566,0,0,3,1630,0,1921,2000
2550,5055,0,0,4,2550,0,1910,0
2500,8866,0,0,4,2500,0,1987,0
2890,6885,0,0,3,1590,1300,1945,2013
1420,5000,0,0,4,1420,0,1945,0
4270,5800,0,3,5,3170,1100,1937,0
2390,1984,0,0,3,2220,170,2008,0
2530,5048,0,0,3,2530,0,2014,0
2701,4500,0,0,3,2701,0,2014,0
3990,6637,0,0,3,3990,0,2003,0
2303,3826,0,0,3,2303,0,2006,0
1540,965,0,0,3,1540,0,2007,0
1450,1053,0,0,3,940,510,2008,0
1160,1458,0,0,3,1040,120,2012,1912
2910,6334,0,0,3,2910,0,2013,1923
3770,8501,0,0,3,3770,0,2008,0
2900,10300,0,0,3,1450,1450,1985,0
1540,3000,0,2,3,770,770,1920,1979
700,3000,0,0,4,700,0,1918,1974
3280,10302,0,0,3,1680,1600,1970,2014
2430,8960,0,0,3,1430,1000,1960,2012
1900,7984,0,0,3,1900,0,1993,0
1660,15050,0,0,3,1260,400,1983,2009
1620,7992,0,0,4,1620,0,1975,0
2090,10800,0,0,4,2090,0,1951,1999
1110,7231,0,0,4,1110,0,1991,0
3760,9792,0,0,3,2550,1210,1984,0
2080,12134,0,0,4,1530,550,1973,0
1950,5950,0,0,3,1330,620,1947,2012
2570,13054,0,1,3,1470,1100,1950,1992
2330,12141,0,0,3,1390,940,1983,2009
3700,10375,0,0,3,3700,0,1982,0
1920,7738,0,0,3,1520,400,1965,1993
1900,3960,0,0,3,1200,700,1905,2010
1440,13296,0,0,4,1440,0,1967,0
2940,48788,0,0,5,1520,1420,1961,0
2500,3080,0,0,3,1810,690,2008,0
2490,23891,0,0,3,2490,0,1993,0
1470,10052,0,0,4,1470,0,1956,0
2120,4558,0,0,3,2120,0,2002,0
1200,24805,0,0,3,1200,0,1984,0
2450,6994,0,0,3,2450,0,2002,0
1780,6000,0,0,3,1780,0,1991,0
1590,6700,0,0,3,1090,500,1942,1999
2370,76665,0,0,4,2370,0,1978,2000
1760,4000,0,0,3,1760,0,1922,2008
1940,8170,0,0,4,1940,0,1948,0
3550,12327,0,0,4,2180,1370,1990,0
2050,5787,0,0,3,2050,0,2002,0
1680,3179,0,0,3,1680,0,2002,0
1320,1800,0,0,3,1320,0,1994,0
1550,5511,0,0,3,1550,0,1987,2000
2680,8625,0,0,5,1590,1090,1974,0
2390,34041,0,0,3,1840,550,1984,0
2040,7260,0,0,4,2040,0,1963,0
2670,6517,0,4,4,2020,650,1977,0
1880,3720,0,0,4,1880,0,1924,0
2400,7700,0,0,4,1500,900,1927,0
2270,11472,0,0,4,1370,900,1956,0
1850,5444,0,0,5,1850,0,1981,0
2160,5005,0,0,3,1430,730,1987,2000
2160,12960,0,0,3,1360,800,1968,1997
1570,3600,0,2,4,1320,250,1906,1990
1340,7200,0,0,4,1340,0,1923,0
3002,6042,0,0,3,3002,0,2004,2003
2190,9072,0,0,5,1110,1080,1965,0
2610,21600,0,0,4,2610,0,1966,0
1010,11919,0,0,3,1010,0,1947,2012
2105,6093,0,0,3,2105,0,2003,0
2430,4748,0,0,3,1630,800,1928,1954
4040,18916,0,0,4,4040,0,1954,1979
2160,7737,0,0,3,2160,0,1998,2006
900,9260,0,0,3,900,0,1946,0
1820,1641,0,0,3,1540,280,2006,0
2100,13468,0,0,5,1050,1050,1962,0
1520,7199,0,0,4,1520,0,1992,0
1310,7128,0,0,4,940,370,1980,0
2190,9880,0,0,4,1410,780,1979,0
2950,5500,0,0,5,1720,1230,1918,0
1870,7800,0,0,3,1580,290,1962,2003
4660,5500,0,4,5,3040,1620,1909,1988
1840,9900,0,0,3,1840,0,1978,0
3180,9400,0,4,5,2610,570,1985,0
1500,4000,0,0,3,1100,400,1933,0
1730,7416,0,0,3,1730,0,1954,2005
1580,7424,0,0,3,1010,570,1962,2003
1540,1870,0,0,3,1540,0,2014,0
3390,3979,0,0,3,2610,780,2014,0
830,1858,0,0,3,830,0,2005,0
2620,6178,0,0,3,2620,0,2013,1923
2242,4500,0,0,3,2242,0,2014,0
2890,7798,0,0,3,2890,0,2005,0
1450,4050,0,0,3,1450,0,2010,0
800,2119,0,0,3,800,0,2008,0
2280,2502,0,0,3,1880,400,2006,0
3850,62726,0,0,3,3120,730,2013,1923
2270,6300,0,0,3,2270,0,1995,0
2250,5692,0,0,3,2250,0,2000,0
2600,11325,0,0,4,1610,990,1969,0
2490,9525,0,0,5,2490,0,1968,0
3160,8281,0,0,4,3160,0,1995,0
4930,25714,0,0,3,4930,0,2005,0
1440,11250,0,0,3,1440,0,1967,2011
1770,8868,0,0,4,1770,0,1959,0
2300,6448,0,0,3,2300,0,2001,0
2980,16263,0,0,3,2980,0,1989,0
2230,7200,0,0,4,1300,930,1963,0
1830,7969,0,0,3,930,900,1950,2008
1740,10875,0,0,4,1020,720,1962,0
1530,6743,0,0,3,1410,120,1955,2005
1520,9041,0,0,4,1520,0,1954,1979
3230,5000,0,2,5,2430,800,1945,0
3620,4000,0,0,3,2730,890,2005,0
5070,60123,0,0,3,5070,0,2000,0
1570,8750,0,0,3,1570,0,1960,2012
2080,7200,0,0,4,1050,1030,1966,0
2230,8624,0,0,4,1430,800,1969,0
3420,18129,0,0,3,2540,880,1952,2005
2790,6695,0,0,3,1470,1320,1977,2004
3150,4203,0,0,3,3150,0,2002,0
3930,10929,0,0,3,3930,0,2006,0
2190,4900,0,0,5,1490,700,1940,0
1890,6962,0,0,3,1890,0,1997,0
1900,76877,0,0,3,1900,0,2004,2003
1930,3521,0,0,3,1930,0,1989,0
3316,11447,0,0,3,3316,0,1986,0
1380,4500,0,0,5,1380,0,1960,0
2080,2250,0,4,3,2080,0,1997,0
1240,5000,0,0,5,1240,0,1909,1988
1020,8610,0,0,5,1020,0,1959,0
2360,4800,0,0,3,2360,0,1909,2014
2780,33503,0,1,4,2110,670,1969,0
2300,13418,0,0,3,1430,870,1955,2005
2020,4350,0,0,5,1730,290,1943,0
1840,10453,0,2,3,1360,480,1948,1994
1390,4814,0,0,3,1390,0,1908,1988
2060,11385,0,0,4,1200,860,1962,0
2640,35070,0,0,3,2640,0,1963,2008
1980,10115,0,0,3,1980,0,1959,1989
1810,5080,0,0,3,1030,780,1958,2004
1700,9000,0,0,5,1700,0,1972,0
1200,6000,0,0,3,1200,0,1923,1998
2980,3600,0,0,3,2150,830,1999,0
1350,1252,0,0,3,1120,230,2006,0
2360,10000,0,3,3,1980,380,1977,2004
1190,6200,0,0,3,1190,0,1948,1994
4110,43560,0,0,4,4110,0,1978,2000
2800,10786,0,0,3,1420,1380,1970,2014
920,1598,0,0,3,920,0,1995,0
1530,8000,0,0,3,1530,0,1978,0
860,5040,0,0,3,860,0,1956,2001
1520,3593,0,0,3,1520,0,2004,2003
660,5240,0,0,4,660,0,1912,1989
3580,8921,0,0,3,3580,0,2000,0
3000,13899,0,0,4,3000,0,1975,0
2740,9629,0,0,5,1390,1350,1977,0
2040,5523,0,0,3,2040,0,1999,0
2520,54160,1,4,3,2520,0,1954,2005
2470,8800,0,0,3,2470,0,1961,2004
1930,1348,0,0,3,1300,630,2005,0
2950,10254,0,0,3,2950,0,2006,0
2610,6405,0,0,3,2610,0,2001,0
1630,1526,0,0,3,1630,0,2014,0
1400,1022,0,0,3,1400,0,2007,0
1410,1005,0,0,3,900,510,2011,0
4370,10860,0,0,3,4370,0,2008,0
5010,19412,0,1,3,4000,1010,2014,0
2590,6160,0,0,3,2590,0,2014,0
1300,7200,0,0,5,1300,0,1960,0
2320,7609,0,0,3,2320,0,2003,0
2700,4275,0,0,3,2700,0,2004,2003
2920,6513,0,0,4,2260,660,1937,0
3130,5700,0,0,3,1750,1380,1953,0
1470,4950,0,0,3,1030,440,1984,0
1540,1326,0,0,3,1390,150,1995,0
3160,4620,0,4,3,2020,1140,1917,2005
1480,7700,0,0,3,1480,0,1975,0
3595,5639,0,0,3,3595,0,2014,0
1190,4440,0,0,3,1190,0,1981,2013
2340,217014,0,0,4,2340,0,1982,2011
1320,2500,0,0,3,870,450,1918,0
1190,27007,0,0,4,1190,0,1910,0
2350,18600,0,0,4,2350,0,1977,0
1100,8560,0,0,3,1100,0,1961,2004
1660,4704,0,0,3,1260,400,1930,1997
3040,36246,0,0,3,2680,360,1923,2014
1860,4777,0,0,5,1860,0,1908,0
4100,241322,0,0,3,2500,1600,1981,2013
4050,36171,0,0,4,2620,1430,1970,0
1240,2500,0,0,3,1240,0,1985,0
2200,10800,0,0,3,2200,0,1960,2012
1680,9090,0,0,4,1130,550,1959,0
930,5160,0,0,5,930,0,1919,1934
1800,22000,0,0,3,1800,0,1931,0
3000,8401,0,0,3,1500,1500,1979,2014
1820,12686,0,0,4,1820,0,1952,0
1995,7102,0,0,4,1995,0,1981,0
3990,9786,0,0,3,3990,0,2004,2003
800,5192,0,0,5,800,0,1951,0
960,9563,0,0,5,960,0,1967,0
2286,8269,0,0,3,2286,0,2002,0
2220,11646,0,0,3,1270,950,1950,2005
1940,7500,0,0,4,1940,0,1918,1985
1640,7222,0,0,4,1640,0,1908,0
1120,10576,0,0,4,1120,0,1969,0
2600,4800,0,2,3,1400,1200,1953,0
1490,4800,0,0,5,1490,0,1948,1985
1650,3000,0,0,3,1650,0,1902,0
2400,6137,0,0,3,2400,0,1990,2009
1500,6685,0,0,3,1190,310,1926,2003
1990,12793,0,0,3,1990,0,1993,0
1130,746,0,0,3,1030,100,2009,0
2030,11070,0,0,4,2030,0,1980,0
1590,7920,0,0,4,1590,0,1960,2001
1480,8394,0,0,4,1480,0,1971,0
2690,18653,0,0,3,2690,0,1985,0
3870,46609,0,3,3,3870,0,1997,0
1390,6000,0,0,3,1390,0,1954,2005
1830,1850,0,0,3,1690,140,2011,0
1580,5750,0,0,5,790,790,1910,0
2590,15229,0,3,3,2590,0,1984,0
2510,8050,0,0,4,1490,1020,1977,0
1180,7300,0,0,4,1180,0,1968,0
1450,19206,0,0,3,1450,0,1989,0
3110,6765,0,1,4,2550,560,1946,1989
2860,68519,0,0,5,2860,0,1958,0
2760,8476,0,0,4,1690,1070,1967,0
2800,17788,0,0,4,1400,1400,1963,0
1450,3748,0,0,3,1450,0,2004,2003
2530,5650,0,0,4,1910,620,1910,0
1640,2808,0,3,4,820,820,1924,0
2220,17568,0,0,4,2220,0,1967,0
2040,10086,0,0,3,2040,0,1987,2000
1230,6000,0,0,4,1230,0,1967,0
1060,7700,0,0,3,820,240,1981,2013
1920,9625,0,0,3,1920,0,1993,0
1520,4170,0,0,3,1520,0,2004,2003
3770,4103,0,0,5,2710,1060,1925,0
3540,38322,0,0,3,3540,0,1989,0
5430,108900,0,0,4,5430,0,1987,0
2250,7904,0,0,3,2250,0,1998,2006
2090,5195,0,0,3,2090,0,2007,0
1720,3012,0,0,3,1720,0,2011,0
1910,2091,0,0,3,1910,0,2014,0
1601,2491,0,0,3,1536,65,2007,0
1060,1209,0,0,3,940,120,2006,0
2330,3920,0,0,3,2330,0,2005,0
2370,4200,0,0,3,2370,0,2014,0
1420,1237,0,0,3,1420,0,2014,0
2360,4000,0,0,3,2360,0,2013,1923
1260,1575,0,0,3,1260,0,2001,0
3030,9053,0,0,3,3030,0,2009,0
1140,1201,0,0,3,1140,0,2014,0
2820,9375,0,0,4,1550,1270,1968,0
1270,1372,0,0,3,1270,0,2000,0
3180,12600,0,0,4,3180,0,1978,2000
2790,13791,0,3,3,2790,0,2006,0
2570,9503,0,0,3,2570,0,1980,0
1080,2674,0,0,4,720,360,1919,1985
3010,7221,0,0,3,3010,0,2004,2003
2120,14915,0,0,3,1720,400,1979,2014
1900,46609,0,0,4,1440,460,1969,0
2860,43821,0,0,4,2860,0,1990,0
910,10575,0,0,4,910,0,1968,0
2850,37522,0,0,3,2850,0,1987,2000
2560,2500,0,0,5,1690,870,1901,0
1570,16817,0,0,3,1570,0,1982,0
3110,108464,0,2,4,3110,0,1979,0
4740,126759,0,0,4,4740,0,1991,0
1340,13750,0,0,4,1340,0,1955,2009
2600,6390,0,0,3,1390,1210,1978,0
1070,8030,0,0,3,1070,0,1966,2014
1820,9670,0,0,3,1820,0,1984,0
1060,3040,0,0,3,860,200,1924,2011
2220,4060,0,0,3,1330,890,1993,0
1350,8700,0,0,3,1350,0,1942,1999
2510,9180,0,1,4,1600,910,1975,0
2340,13713,0,0,2,1670,670,1967,0
1060,7920,0,0,4,1060,0,1968,0
2200,8065,0,0,3,2200,0,1998,2006
1400,8100,0,0,3,1400,0,1944,0
1520,7123,0,0,4,1520,0,1959,0
1810,3000,0,0,3,1810,0,1998,2006
2360,11340,0,0,3,2360,0,1997,0
1210,1032,0,0,3,1210,0,2014,0
3420,25150,0,0,4,1750,1670,1987,0
1810,4592,0,0,3,1810,0,1992,0
2760,10160,0,0,3,2760,0,1969,2010
1950,9800,0,0,3,1330,620,1968,1997
3830,48743,0,0,3,3830,0,1991,0
2060,7283,0,0,3,1220,840,1963,2013
1650,6400,0,0,4,980,670,1954,1979
2100,11942,0,0,3,1030,1070,1964,2000
3720,57499,0,0,3,1880,1840,2003,0
1920,8562,0,2,4,1920,0,1994,0
1860,217800,0,2,3,1860,0,1998,2006
2290,3507,0,0,3,2290,0,2005,0
1200,9085,0,0,4,1200,0,1968,0
5270,53428,0,0,3,3440,1830,2004,2003
1600,2788,0,0,4,1600,0,1992,0
2560,4020,0,0,3,2560,0,2006,0
880,4000,0,0,3,880,0,1940,1996
1020,7920,0,0,3,1020,0,1939,1969
960,9380,0,0,3,960,0,1949,1998
1900,7200,0,0,3,1370,530,1977,2004
1320,6000,0,0,4,1320,0,1920,0
2230,9640,0,0,3,1320,910,1998,2006
1150,7314,0,0,3,1150,0,1960,2012
3440,6000,0,0,4,3440,0,2002,0
1070,8179,0,0,3,1070,0,1949,1998
2250,3433,0,0,3,1500,750,1927,2013
1910,10300,0,0,3,1910,0,1921,1968
1180,16552,0,0,4,1180,0,1967,0
1400,7360,0,0,4,1400,0,1968,0
3580,9316,0,0,3,2370,1210,1991,0
3176,13391,0,3,4,2726,450,1985,0
1170,1890,0,1,4,1170,0,1927,0
1570,4665,0,0,3,1570,0,2006,0
1460,15000,0,0,3,1460,0,1966,1963
1140,10400,0,0,4,1140,0,1983,0
1150,9812,0,0,4,1150,0,1962,0
3180,31931,0,0,4,2390,790,1978,2000
2630,6185,0,0,3,2630,0,1999,0
1940,5980,0,0,3,1520,420,1987,2000
850,8050,0,0,2,850,0,1906,0
1550,6039,0,0,5,830,720,1942,0
2090,15000,0,0,3,2090,0,1961,2004
3960,6654,0,0,3,2850,1110,2006,0
1320,5000,0,0,3,1320,0,1912,1994
3220,35400,0,0,3,3220,0,1991,0
800,7260,0,0,3,800,0,1953,0
1660,9673,0,0,3,1130,530,1976,0
2250,11370,0,0,3,2250,0,1991,0
2120,13090,0,0,3,2120,0,1997,0
2310,4020,0,0,5,2310,0,1979,0
1920,7700,0,0,4,1920,0,1970,0
1550,9720,0,0,3,1050,500,1976,0
1785,779,0,0,3,1595,190,1975,0
1830,9848,0,0,5,1830,0,1962,0
3500,5040,0,2,3,2950,550,1927,2007
2560,14680,0,0,3,1330,1230,1987,2000
1360,4840,0,0,4,1360,0,1928,0
6500,14986,0,0,3,5180,1320,2001,0
3150,5500,0,0,3,3150,0,2014,0
810,4080,0,0,4,810,0,1941,1998
7320,217800,0,0,3,7320,0,1992,0
2790,17476,0,2,3,1450,1340,1956,2001
1920,3408,0,0,4,960,960,1912,1989
2530,14178,0,0,3,2530,0,1997,0
3490,8343,1,4,4,2150,1340,1939,1991
4710,11000,0,3,3,3690,1020,1931,0
2050,16313,0,0,2,2050,0,1973,0
2410,8400,0,0,5,2410,0,1965,0
1180,8240,0,0,4,1180,0,1967,0
630,4200,0,0,3,630,0,1930,1997
3480,7800,0,0,4,1750,1730,1941,1998
1010,7683,0,0,5,1010,0,1953,0
1910,3481,0,0,3,1910,0,2009,0
2490,3582,0,0,3,1720,770,2005,0
2150,3143,0,0,3,2150,0,2010,0
3000,5470,0,0,3,3000,0,2005,0
2830,3496,0,0,3,2830,0,2012,1912
2680,5539,0,0,3,2680,0,2013,1923
1090,2686,0,0,3,1090,0,1982,0
1984,32400,0,0,3,1564,420,1962,2003
3090,5859,0,0,3,3090,0,2010,0
2610,5140,0,0,3,2610,0,2006,0
3370,3634,0,0,3,2750,620,2007,0
2250,3916,0,0,3,2250,0,2014,0
1450,1387,0,0,3,1180,270,2013,1923
3130,10849,0,0,3,3130,0,2013,1923
2700,8572,0,0,3,2700,0,2007,0
1970,5400,0,0,3,1320,650,1986,0
1970,4166,0,3,5,1270,700,1929,0
1950,15954,0,0,4,1950,0,1959,0
1940,9887,0,0,4,1140,800,1969,0
3550,11000,0,2,3,2260,1290,1999,0
2500,7394,0,0,3,2500,0,1990,2009
2910,18700,0,0,3,2210,700,1957,1995
3350,35298,0,0,4,3350,0,1985,0
2140,40098,0,0,5,1490,650,1950,0
4030,13474,0,0,3,4030,0,2000,0
1980,6660,0,0,4,1980,0,1974,0
1460,9908,0,0,3,1460,0,1952,2008
1880,8800,0,0,3,1130,750,1960,2012
2320,10900,0,0,3,2320,0,1935,1974
2220,8227,0,0,5,1770,450,1929,0
1410,7200,0,0,4,1410,0,1901,0
1240,3500,0,0,4,1240,0,1927,0
2030,8426,0,0,3,2030,0,1944,0
4000,6015,0,2,3,3080,920,2004,2003
490,38500,0,0,4,490,0,1959,0
1590,3411,0,0,3,1590,0,2000,0
2630,5827,0,0,3,2630,0,2001,0
1350,4614,0,0,3,1350,0,2008,0
990,4440,0,0,3,990,0,1943,2002
3710,7984,0,0,3,3710,0,1999,0
990,8062,0,0,4,990,0,1960,2001
2510,4543,0,0,3,2510,0,2002,0
800,6500,0,0,4,800,0,1953,1983
1600,10183,0,0,4,1600,0,1966,0
3320,11340,0,0,4,2480,840,1999,0
1730,9230,0,0,3,1010,720,1962,2003
2000,3988,0,4,4,1000,1000,1958,1972
2910,6308,0,0,3,1640,1270,1985,0
1710,10440,0,0,4,1710,0,1955,2009
1200,7800,0,0,4,1200,0,1954,1979
2600,5100,0,1,3,2600,0,1998,2006
1460,7926,0,0,4,1460,0,1987,0
4260,9800,0,0,3,4260,0,2008,0
2100,4480,0,0,4,1780,320,1928,0
4230,6420,0,3,4,2360,1870,1916,0
1660,6250,0,0,3,830,830,1980,0
1450,7200,0,0,3,1010,440,1969,2010
1860,5040,0,0,5,1860,0,1920,0
2720,10006,0,0,3,2720,0,1989,0
2920,5500,0,3,3,2030,890,1957,2000
1800,12196,0,0,4,1800,0,1966,0
1320,8830,0,0,3,1020,300,1939,1969
1770,29004,0,0,3,1770,0,1959,1989
2550,7725,0,0,5,1390,1160,1967,0
2150,9000,0,0,4,1110,1040,1966,0
3020,7465,0,0,3,3020,0,2004,2003
960,27442,0,0,4,960,0,1970,0
2783,11177,0,0,3,2783,0,1910,1999
2250,14274,0,0,4,1500,750,1964,0
1710,8767,0,0,4,1710,0,1986,0
2650,9380,0,0,5,1680,970,1975,0
1830,1804,0,0,3,1830,0,2014,0
1460,3044,0,0,3,1460,0,2000,0
1760,6875,0,0,4,1760,0,1967,0
1960,6058,0,0,3,1960,0,2002,0
2010,7688,0,0,3,1170,840,1979,2014
3670,9958,0,0,3,3670,0,2005,0
2290,9772,0,0,3,2290,0,2007,0
1780,5720,0,0,5,980,800,1925,0
3080,35430,0,0,3,3080,0,1997,0
3360,15091,0,0,3,3360,0,1997,0
1370,6780,0,0,3,1370,0,1930,1997
1660,8063,0,0,4,1660,0,1978,2000
4440,10660,0,0,3,4440,0,2003,0
2850,209523,0,0,4,1930,920,1925,1968
1530,2913,0,0,4,1530,0,1986,0
2100,8400,0,0,4,1240,860,1976,1992
730,1942,0,0,3,730,0,2008,0
1920,8223,0,0,4,1920,0,1989,0
1600,7324,0,0,4,1600,0,1958,1972
2380,17199,0,0,3,1530,850,1979,2014
2760,17377,0,0,3,2760,0,2002,0
1840,11367,0,0,4,1840,0,1950,1983
2580,5750,0,0,4,1880,700,1901,0
2100,4750,0,0,3,1340,760,1975,0
1820,5015,0,0,4,1190,630,1926,1993
4830,18707,0,1,5,3930,900,1952,1998
1550,4980,0,0,3,1080,470,1978,0
1440,3600,0,0,4,1440,0,1924,0
930,6380,0,0,4,930,0,1940,2001
3560,12047,0,0,3,3560,0,1988,2000
840,11600,0,0,3,840,0,1952,2008
4280,47179,0,0,3,3050,1230,2002,0
1500,10018,0,0,4,1500,0,1957,2001
3650,38546,0,0,3,2550,1100,1996,0
780,3910,0,0,3,780,0,1918,0
1600,5500,0,0,4,1600,0,1946,1989
1120,8250,0,0,4,1120,0,1966,0
1010,9219,0,0,4,1010,0,1960,2001
1970,37026,0,0,4,1970,0,1961,2001
2230,4372,0,0,5,1540,690,1935,0
4290,20445,0,0,4,4290,0,1985,0
3160,76230,0,0,4,2160,1000,1978,2000
1850,5100,0,0,3,1020,830,1909,2004
1980,8755,0,0,4,1300,680,1963,0
3360,9767,0,0,3,2450,910,1990,2009
2660,192099,0,0,4,2660,0,1964,0
1200,7280,0,0,4,1200,0,1967,0
2150,5760,0,0,3,2150,0,2010,0
2820,5348,0,0,3,2820,0,2008,0
3510,9400,0,0,3,3510,0,2014,0
1790,3078,0,0,3,1790,0,2010,0
2700,6000,0,0,4,2100,600,1910,0
5780,17004,0,0,3,4260,1520,2006,0
3730,4560,0,0,3,2760,970,2013,1923
2540,5001,0,0,3,2540,0,2005,0
3300,8365,0,0,3,3300,0,2014,0
5430,10327,0,2,3,4010,1420,2007,0
2550,5200,0,0,3,2550,0,2009,0
1390,1484,0,0,3,1390,0,2007,0
1270,1413,0,0,3,1270,0,2007,0
2380,5000,0,0,3,2380,0,2005,0
3360,22111,0,0,3,3360,0,1994,0
6070,171626,0,0,3,6070,0,1999,0
1240,57000,0,0,3,1240,0,1962,2003
2930,14057,0,2,4,1680,1250,1980,0
2410,102366,0,0,4,1940,470,1912,1989
2980,5000,0,0,3,2480,500,1916,1986
1950,2719,0,0,5,1010,940,1919,1934
2600,36583,0,0,5,1580,1020,1976,0
1170,8147,0,0,3,1170,0,1959,1989
1470,6500,0,0,4,1470,0,1953,1983
1840,5419,0,0,4,920,920,1942,1982
1560,7500,0,0,4,1560,0,1968,0
1520,7700,0,0,4,1520,0,1967,0
2220,4000,0,0,3,1700,520,1914,2000
2800,9538,0,0,3,2800,0,1993,0
670,6300,0,0,5,670,0,1942,0
1720,7885,0,0,3,1720,0,1983,2009
2110,4038,0,0,4,2110,0,1989,0
1580,9187,0,0,3,1180,400,1993,0
2640,3680,0,0,5,1760,880,1922,1956
2700,6515,0,0,3,2700,0,1998,2006
2820,8159,0,0,3,2820,0,2004,2003
3340,8930,0,2,3,3340,0,1999,0
1530,6000,0,0,4,1530,0,1991,0
3840,85728,0,0,3,3840,0,1998,2006
2320,10960,0,0,3,1510,810,1956,2001
2310,13430,0,0,4,2310,0,1966,0
1770,1235,0,0,3,1600,170,2007,0
3160,66646,0,0,3,3160,0,1993,0
1620,6630,0,0,3,1280,340,1954,2005
1510,4235,0,0,3,1510,0,1955,2005
960,8106,0,0,3,960,0,1962,2003
1740,8449,0,0,4,1170,570,1958,1972
1470,8395,0,0,4,1470,0,1965,0
2460,4200,0,0,3,2460,0,1998,2006
1170,8182,0,0,3,1170,0,1962,2003
1210,7507,0,0,3,1210,0,1982,0
1870,7942,0,0,3,1870,0,1990,2009
1950,5689,0,0,3,1950,0,2009,0
2570,5250,0,0,3,2570,0,1990,2009
1460,10311,0,0,4,1460,0,1975,0
2970,23100,0,0,3,1510,1460,1967,2011
2040,21781,0,0,3,2040,0,1994,0
3240,6551,0,4,4,2500,740,1939,1989
3150,67518,0,0,4,2250,900,1965,0
1820,8008,0,0,3,1240,580,1981,2013
2130,35752,0,0,3,1490,640,1980,0
1430,8000,0,0,4,1430,0,1956,0
2030,6970,0,0,4,2030,0,1991,0
2000,5827,0,0,3,2000,0,1997,0
1940,6206,0,0,3,1940,0,1990,2009
880,6780,0,0,4,880,0,1945,0
950,9400,0,0,4,950,0,1954,1979
1670,1596,0,0,3,1220,450,2002,0
2670,10496,0,0,3,2670,0,1989,0
2700,1438,0,0,3,1280,1420,2003,0
590,833,0,0,4,590,0,1926,1993
2160,8119,0,0,3,1080,1080,1966,1913
2700,8810,0,0,3,2700,0,2004,2003
3206,5793,0,0,3,3206,0,2012,1912
1560,9788,0,0,3,1560,0,1964,2000
1400,6956,0,0,4,1400,0,1957,2001
3090,6744,0,4,3,3090,0,2013,1923
2630,16475,0,0,4,2630,0,1953,1983
2190,11394,0,0,3,1550,640,1956,2001
2100,9200,0,0,3,1050,1050,1959,1989
1120,5427,0,0,3,1120,0,1969,2014
3260,19542,0,0,4,2170,1090,1968,0
1180,7793,0,0,4,1180,0,1992,0
780,16344,0,0,1,780,0,1942,0
2200,9397,0,0,3,2200,0,1987,2000
1340,306848,0,0,3,1340,0,1953,0
1490,10125,0,0,4,1490,0,1962,0
2800,5900,0,0,3,1660,1140,1963,2008
2600,5390,0,0,4,1300,1300,1960,2001
3200,9200,0,2,4,1600,1600,1953,1983
3480,36615,0,0,4,2490,990,1983,0
3020,4082,0,0,3,2080,940,1954,2004
1970,11088,0,0,4,1180,790,1967,0
1500,7112,0,0,5,760,740,1920,0
3680,18804,0,0,3,3680,0,1990,2009
1570,7200,0,0,4,1570,0,1952,0
2280,2289,0,0,3,1880,400,2006,0
1600,3573,0,0,3,1600,0,2013,1923
1680,1570,0,0,3,1680,0,2014,0
1890,13860,0,0,5,1890,0,1966,0
520,22334,0,0,2,520,0,1951,0
1780,191228,0,2,3,1780,0,1988,2000
2920,33976,0,3,5,1460,1460,1964,0
2430,73151,0,0,3,2430,0,1974,0
3010,1842,0,0,3,3010,0,2011,0
1620,30736,0,0,4,1620,0,1911,1977
2200,188200,0,3,3,2200,0,2007,0
2950,78843,0,0,3,2950,0,2006,0
2170,10500,0,2,4,1270,900,1960,2001
1770,17208,0,0,3,1160,610,1959,1989
1830,8209,0,0,3,1830,0,1942,1999
2380,7066,0,0,4,2380,0,1997,0
2550,10000,0,0,3,1290,1260,1964,2000
3720,11610,0,0,3,3720,0,1982,0
4630,6324,0,0,3,3210,1420,2006,0
4430,9000,0,0,3,4430,0,2013,1923
1490,1709,0,0,3,1490,0,2004,2003
5030,11023,0,2,3,3250,1780,2008,0
2180,22870,0,0,4,1280,900,1954,1975
1590,131551,0,3,4,1590,0,1966,0
1510,7066,0,2,3,1230,280,1973,2013
4210,10308,0,0,3,4210,0,2006,0
1640,9972,0,0,4,1640,0,1977,0
1840,1562,0,0,3,1400,440,2004,2003
1040,5000,0,0,3,1040,0,1959,1989
1250,4800,0,0,4,1250,0,1951,1999
3690,12353,0,0,5,3690,0,1977,0
1530,7200,0,0,3,1400,130,1948,1994
2110,3750,0,0,3,2110,0,2000,0
2150,4333,0,0,3,1200,950,1956,2001
5340,10655,0,3,4,3740,1600,1912,1989
2420,7672,0,0,3,1480,940,1979,2014
5010,34460,0,0,3,5010,0,1988,2000
910,9612,0,0,4,910,0,1981,0
2200,5000,0,0,3,2200,0,1932,0
3430,64441,0,0,3,3430,0,2013,1923
1860,6687,0,0,4,1220,640,1983,0
3300,4545,0,4,3,2600,700,1926,1999
1280,10716,0,0,4,1280,0,1969,0
1490,7770,0,0,4,1490,0,1990,0
2880,11965,0,0,4,2880,0,1990,0
1310,5200,0,0,3,1160,150,1945,2010
1980,7403,0,0,3,1980,0,1988,2000
2000,7900,0,0,4,1300,700,1986,0
1860,7440,0,0,5,1040,820,1954,0
1990,6180,0,0,3,1990,0,1990,2009
1720,8300,0,0,4,1720,0,1973,0
1370,78408,0,0,5,1370,0,1964,0
4060,35621,0,0,3,2030,2030,1989,0
1960,9898,0,0,3,1960,0,2001,0
1720,9600,0,0,3,1120,600,1961,2004
2740,12899,0,0,4,2740,0,1990,0
1360,13372,0,0,3,1360,0,1955,2005
1870,5449,0,0,3,1870,0,2003,0
720,4222,0,0,4,720,0,1942,1982
2180,7741,0,0,3,2180,0,1986,0
1430,8960,0,0,4,1430,0,1953,1983
780,6685,0,0,4,780,0,1948,0
1180,5002,0,0,3,1180,0,1946,0
1300,3731,0,0,3,900,400,1993,0
4260,18000,0,2,3,4260,0,2000,0
2050,11900,0,0,4,2050,0,1950,1983
2930,19876,0,0,3,2030,900,1993,0
1500,4120,0,0,3,880,620,1928,1954
5960,13703,0,2,3,4770,1190,1984,0
810,4800,0,0,3,810,0,1919,2001
2320,4344,0,0,3,2320,0,2012,1912
1090,5000,0,0,4,730,360,1942,1982
1000,4776,0,0,4,1000,0,1942,1982
2260,19821,0,0,3,2260,0,1994,0
1290,5000,0,0,3,1290,0,1957,2000
2120,7560,0,0,3,2120,0,1991,0
1490,4522,0,0,3,1490,0,2009,0
2310,5100,0,0,3,2310,0,2013,1923
720,6000,0,0,3,720,0,1940,1996
1840,3035,0,0,3,920,920,1926,2003
2910,36250,0,0,3,1590,1320,1977,2004
3270,12880,0,0,3,3270,0,2014,0
3040,10257,0,0,3,3040,0,1993,0
1200,9936,0,0,4,1200,0,1969,0
2740,5616,0,0,5,1670,1070,1925,0
2290,5350,0,0,4,2120,170,1958,1972
2580,6000,0,0,5,1300,1280,1950,0
1590,27200,0,0,4,1590,0,1926,1993
1040,6860,0,0,3,1040,0,1942,1999
1300,6710,0,0,4,1300,0,1952,0
2090,4698,0,0,3,2090,0,1998,2006
2670,3800,0,0,3,2670,0,2014,0
1540,115434,0,0,4,1540,0,1923,0
3370,12447,0,0,3,3370,0,1991,0
1730,11325,0,0,5,1730,0,1972,0
1640,29970,0,0,3,1640,0,1992,0
2980,8051,0,2,4,2020,960,1935,0
1330,8100,0,0,4,1330,0,1969,0
2192,12128,0,0,3,2192,0,2006,0
2068,7242,0,0,4,2068,0,1976,1992
1980,6250,0,1,5,1090,890,1910,0
1710,1664,0,0,5,1300,410,2003,0
890,4590,0,0,3,890,0,1923,1998
4280,9583,0,0,3,4280,0,2005,0
3080,12476,0,0,3,3080,0,1990,2009
2070,7500,0,0,4,2070,0,1977,0
3010,7215,0,0,3,3010,0,2014,0
2030,9300,0,0,4,2030,0,1976,1992
4060,19290,0,0,3,4060,0,2002,0
2340,16500,0,0,4,1500,840,1972,0
2340,5957,0,0,3,2340,0,1995,0
1470,7137,0,0,3,1020,450,1941,1994
3700,21755,0,4,3,2620,1080,1988,2000
1200,7200,0,0,3,1200,0,1944,0
2910,53898,0,0,5,1510,1400,1979,0
1910,7200,0,0,4,1110,800,1951,1999
2880,13500,0,4,5,1520,1360,1950,0
3240,6863,0,0,3,3240,0,2013,1923
1590,8219,0,0,5,970,620,1938,0
3690,11928,0,0,3,2540,1150,2006,0
2480,5137,0,0,3,2480,0,2000,0
2683,40386,0,0,4,2683,0,1987,0
1100,8281,0,0,4,1100,0,1947,1988
2080,3500,0,0,5,1260,820,1926,0
2210,10119,0,0,4,1450,760,1966,0
2420,4000,0,0,5,1870,550,1911,1984
1240,1666,0,0,3,1000,240,2008,0
2300,3060,0,0,3,1510,790,1930,2002
1760,12874,0,0,4,1230,530,1967,0
2020,8555,0,0,4,1220,800,1957,2001
2500,5801,0,0,3,1960,540,1926,2003
760,5500,0,0,3,760,0,1947,2012
1580,5340,0,0,3,1130,450,1947,2012
2670,10481,0,0,3,2670,0,2003,0
1140,8366,0,0,5,1140,0,1943,0
3870,8225,0,0,3,3870,0,1998,2006
2750,18029,0,2,5,1810,940,1978,0
1570,7000,0,2,4,1050,520,1971,0
1160,22470,0,0,4,1160,0,1976,1992
2110,7665,0,0,4,1360,750,1973,0
1270,2509,0,0,3,1270,0,2004,2003
3250,4500,0,0,3,3250,0,2009,0
940,9839,0,0,3,940,0,1910,2006
2310,68824,0,0,4,2310,0,1968,0
1130,12519,0,0,3,1130,0,1958,2004
3020,13783,0,0,3,3020,0,1952,2002
3210,14910,0,0,3,3210,0,1995,0
2650,40705,0,0,3,2650,0,1994,0
1150,8079,0,0,4,1150,0,1983,0
3910,19023,0,0,3,3910,0,1985,0
3490,5000,0,0,3,3490,0,2003,0
3330,19126,0,0,4,2610,720,1977,0
1940,5753,0,0,3,1940,0,1947,2012
1800,2700,0,0,3,1800,0,2011,0
1880,11249,0,0,3,1330,550,1985,0
2870,6280,0,0,4,1980,890,1905,0
1960,11600,0,0,5,980,980,1931,0
1810,7500,0,0,2,1410,400,1959,0
1490,6770,0,0,3,1490,0,1926,2003
5230,17826,1,4,3,3740,1490,2005,0
3390,9760,0,0,5,1750,1640,1978,0
880,6413,0,0,3,880,0,1950,2005
2550,21675,0,1,4,1610,940,1958,1972
3160,13194,0,0,5,3160,0,1965,0
4550,18641,1,4,3,2600,1950,2002,0
3831,13800,1,4,3,3831,0,1959,1980
1240,3000,0,0,3,1240,0,1906,2014
2520,14021,0,0,3,2520,0,1999,0
2420,10200,0,0,4,2420,0,1973,0
1250,7400,0,0,5,1250,0,1959,0
1310,7300,0,0,3,1310,0,1957,2000
1410,8053,0,0,4,1410,0,1951,1999
990,9798,0,0,3,990,0,1968,1997
1000,8512,0,0,3,1000,0,1991,0
2000,7560,0,0,4,1300,700,1968,0
1120,5650,0,0,3,1120,0,1944,0
3370,7947,0,0,3,3370,0,2001,0
2210,4000,0,0,3,2210,0,2008,0
2640,6895,0,0,3,2640,0,2001,0
1150,887,0,0,3,1150,0,2007,0
2150,27540,0,0,3,2150,0,1997,0
4230,31747,0,0,4,4230,0,1985,0
1570,15330,0,0,3,1080,490,1956,2001
1630,7700,0,0,3,1120,510,1978,0
2770,10274,0,0,3,2770,0,1989,0
1750,7800,0,0,4,1150,600,1956,0
1090,8160,0,0,3,1090,0,1967,2014
930,7740,0,0,3,930,0,1924,2011
2100,4857,0,0,3,2100,0,1965,1984
2540,38677,0,0,3,2540,0,1987,2000
810,8424,0,0,4,810,0,1959,0
1520,8040,0,0,5,1520,0,1951,0
690,1950,0,0,3,690,0,1928,1954
2370,3672,0,0,5,1650,720,1916,0
3500,8750,0,4,5,2140,1360,1951,0
840,3400,0,2,4,840,0,1924,0
1830,8734,0,0,4,1830,0,1991,0
1370,1524,0,0,3,1370,0,2005,0
2520,16100,0,3,4,1570,950,1960,2001
2130,4920,0,4,4,1530,600,1941,1998
2590,8483,0,0,3,2590,0,1991,0
1820,20011,0,0,3,1820,0,1987,2000
1530,3210,0,0,5,1010,520,1928,1970
4080,18362,0,2,4,4080,0,1983,0
1050,6600,0,0,3,1050,0,1964,2000
1954,4805,0,0,3,1954,0,2005,0
1530,3503,0,1,4,830,700,1916,0
1660,4800,0,0,3,1660,0,1922,2008
3830,4800,0,0,3,3050,780,1919,2004
1490,1036,0,0,3,1090,400,2008,0
1520,9030,0,0,3,1520,0,1956,2001
8020,21738,0,0,3,8020,0,2001,0
2470,7410,0,0,5,1860,610,1977,0
870,4600,0,0,4,870,0,1942,1982
2110,12653,0,0,4,2110,0,1972,0
1990,4000,0,0,5,1090,900,1952,1998
1560,7552,0,0,4,910,650,1948,0
1740,4200,0,0,4,1640,100,1920,0
1290,4650,0,0,4,1290,0,1906,1990
1700,8640,0,0,3,850,850,1955,2010
1880,10032,0,0,4,1880,0,1984,0
1890,3330,0,0,4,1390,500,1901,0
1620,1075,0,0,3,1540,80,2009,0
770,8149,0,0,3,770,0,1948,1994
2890,18226,1,4,3,2890,0,1984,0
1040,8892,0,0,4,800,240,1958,1972
2620,8331,0,0,3,2620,0,1991,0
1880,5752,0,0,4,940,940,1945,0
2530,8169,0,0,3,2530,0,1993,0
2538,4600,0,0,3,2538,0,2013,1923
1610,7223,0,0,3,1610,0,1994,0
1510,6360,0,0,4,1510,0,1954,1979
1460,7573,0,0,3,1460,0,1983,2009
3010,7014,0,0,3,3010,0,2009,0
2090,6630,0,0,3,1070,1020,1974,0
1490,8102,0,0,4,1490,0,1990,0
